It's a beautiful day in the dungeon, and you are a horrible goose.
Thanks to Danny O'Brien and Ada Norton for playtesting.
Thanks to Eunju Beck for the cover art.

Try typing "help" for instructions on how to play.

Roguelike Goose
An Interactive Fiction by Lizzard
Release 1 / Serial number 200112 / Inform 7 build 6M62 (I6/v6.33 lib 6/12N) SD

Mysterious ruins
Stone crumbles in a blasted wasteland. Grey, twisted trees grow from crevices in the walls. A narrow staircase descends into darkness.

I beg your pardon?

I beg your pardon?

>d
The walls rumble. Rocks fall.
You can't see the sky anymore!
There is no way out.

Dungeon Entrance
Stone walls, mildewed with glowing stuff, widen into a large bare room.

You can see a wispy ghost, a diamond tiara and a giant rat here.

Exits: west (Evil Archives)

* * *

I beg your pardon?

>down
Grunting with effort, you clamber over the rocky floor.

The walls rumble. Rocks fall.
You can't see the sky anymore!
There is no way out.

Dungeon Entrance
Stone walls, mildewed with glowing stuff, widen into a large cold room. 

A large, colorful sign is on the wall.

You can see a wispy ghost and a trophy case (empty) here.

Exits: east (Hall of Time)

>peck ghost
You viciously peck the wispy ghost, causing 5 points of damage!
You viciously peck the wispy ghost, causing 9 points of damage!

The wispy ghost trips and falls.
"Level 1 humans only, that's what they promised," it shrieks, scuttling away.
The wispy ghost drags itself off into the darkness.

Exits: east (Hall of Time)

[Your score has just gone up by one point.]

>e
Your beady-eyed glance darts across yet another corridor.

Hall of Time
A long, narrow hall, flickering with light from magefire sconces. The painted walls show the progression of time through planets and stars, sun and moons.

You can see a tentacled horror here.

Exits: west (Dungeon Entrance) or down (Cavern of the Lake of Tears)

>peck horror
You viciously peck the tentacled horror, causing 7 points of damage!
You viciously peck the tentacled horror, causing 5 points of damage!

The tentacled horror attacks you, causing 6 points of damage!
The tentacled horror attacks you, causing 6 points of damage!

You swoon.
The world shimmers and whirls.
You wake up nestled into a hollow of warm sand.
You feel completely healed after your nap.

Shorehaven
A peaceful, secluded little beach, just the right size for a dungeon-going goose. A good place to tuck your head under your wing for a short nap. Or you can swim out into the lake.

>look
Shorehaven
A peaceful, secluded little beach, just the right size for a dungeon-going goose. A good place to tuck your head under your wing for a short nap. Or you can swim out into the lake.

>i
You are carrying nothing.

>out
But you aren't in anything at the moment.

>swim
The water feels great!
Ominous, like a grim battleship, you glide across the crystal waters.

Cavern of the Lake of Tears
A still, deep lake stretches into the distance. It's vast. You can't see the other side.

~~~~ next direction will be down

Exits: up (Hall of Time) or down (Rockslide Cavern)

>down
Your broad foot webs slappity-slap across the dungeon floor.

You get out of the water.

Rockslide Cavern
Boulders have tumbled down on one side of this cave. It's a tight squeeze to get by them.

You can see a confused adventurer here.

Exits: east (Evil Archives) or up (Cavern of the Lake of Tears)

* * *

It's a beautiful day in the dungeon, and you are a horrible goose.
Thanks to Danny O'Brien and Ada Norton for playtesting.
Thanks to Eunju Beck for the cover art.

Try typing "help" for instructions on how to play.

Roguelike Goose
An Interactive Fiction by Lizzard
Release 1 / Serial number 200112 / Inform 7 build 6M62 (I6/v6.33 lib 6/12N) SD

Mysterious ruins
Stone crumbles in a blasted wasteland. Grey, twisted trees grow from crevices in the walls. A narrow staircase descends into darkness.

>swim
That's not a verb I recognise.

* * *

It's a beautiful day in the dungeon, and you are a horrible goose.
Thanks to Danny O'Brien and Ada Norton for playtesting.
Thanks to Eunju Beck for the cover art.

Try typing "help" for instructions on how to play.

Roguelike Goose
An Interactive Fiction by Lizzard
Release 1 / Serial number 200112 / Inform 7 build 6M62 (I6/v6.33 lib 6/12N) SD

Mysterious ruins
Stone crumbles in a blasted wasteland. Grey, twisted trees grow from crevices in the walls. A narrow staircase descends into darkness.

>actions
Actions listing on.

>d
[going down]

Dungeon Entrance
[going down - succeeded]

>exits
[listing exits]
You can go up (Magnificent ruins) from here.

[listing exits - succeeded]

* * *

>actions
Actions listing on.

>showme
Magnificent ruins - room
    yourself - person

>d
[going down]
The walls rumble. You can't see the sky anymore!
The exit from the dungeon has mysteriously closed.

~~~~ next room will be Den of Darkness
Cardinal directions: north, south, east, west and down
Available directions: north, south, east, west and down
exit list: 
~~~~ next direction will be north

Dungeon Entrance
Stone walls, mildewed with glowing stuff, widen into a large bare room.

You can see a spider here.

[going down - succeeded]

Exits: north

>n
[going north]
~~~~ next room will be Webby Corridor
Cardinal directions: north, south, east, west and down
Available directions: north, south, east, west and down
exit list: south (Dungeon Entrance)
~~~~ next direction will be south

Den of Darkness
You can see a giant bat here.

[going north - succeeded]

Exits: south

* * *

>showme
Magnificent ruins - room
    yourself - person

>exits
[listing exits]
You can go  from here.
[listing exits - succeeded]

* * *

It's a beautiful day in the dungeon, and you are a horrible goose.
Thanks to Danny O'Brien and Ada Norton for playtesting.
Thanks to Eunju Beck for the cover art.

Try typing "help" for instructions on how to play.

Roguelike Goose
An Interactive Fiction by Lizzard
Release 1 / Serial number 200112 / Inform 7 build 6M62 (I6/v6.33 lib 6/12N) SD

Mysterious ruins
Stone crumbles in a blasted wasteland. Grey, twisted trees grow from crevices in the walls. A narrow staircase descends into darkness.

>d
You waddle valiantly forth.

The walls rumble. Rocks fall.
You can't see the sky anymore!
There is no way out.

Dungeon Entrance
Stone walls, mildewed with glowing stuff, widen into a large cold room. 

A large, colorful sign is on the wall.

You can see a healing potion and a trophy case (closed) here.

Exits: east (Rockslide Cavern)

>attack rat
You attack the giant rat, causing 10 points of damage!

The giant rat falls over, gasping in pain. It drags itself off into the darkness.

Exits: west (Webby Corridor)

>attack rat
You attack the giant rat, causing 3 points of damage!

The giant rat falls over, gasping in pain. It drags itself off into the darkness.

Exits: north (Chilly Mausoleum)

>l
Dungeon Entrance
Stone walls, mildewed with glowing stuff, widen into a large bare room.

Exits: north (Chilly Mausoleum)

* * *

>attack rat
You attack the giant rat, causing 10 points of damage!

The giant rat falls over, gasping in pain. It drags itself off into the darkness.

Exits: west (Webby Corridor)

>w
Webby Corridor
Dusty ropes of thick spiderweb festoon the walls.

You can see an iridium bat here.

Exits: east (Dungeon Entrance) or west (Uncanny Lair)

>peck bat
You attack the iridium bat, causing 7 points of damage!

The iridium bat attacks you, causing 4 points of damage!

Exits: east (Dungeon Entrance) or west (Uncanny Lair)

>peck bat
You attack the iridium bat, causing 4 points of damage!

The iridium bat attacks you, causing 5 points of damage!

Exits: east (Dungeon Entrance) or west (Uncanny Lair)

>peck bat
You attack the iridium bat, causing 8 points of damage!

The iridium bat falls over, gasping in pain. It drags itself off into the darkness.

Exits: east (Dungeon Entrance) or west (Uncanny Lair)

>w
Uncanny Lair
Oddly shaped bones are strewn about this rough cave. Some creature made a nest in one corner out of shredded fungus.

Exits: south (Luminous Gardens) or east (Webby Corridor)

>s
Luminous Gardens
Mushrooms the size of trees, glowing, are scattered among winding paths. Tiny lightning bugs flit between snow-pale cave blossoms.

Exits: north (Uncanny Lair) or east (Chilly Mausoleum)

>e
Chilly Mausoleum
Cold seeps into your bones. Faceless tombs loom overhead.

You can see a soot sprite here.

Exits: west (Luminous Gardens) or down (Hall of Time)

>peck sprite
You attack the soot sprite, causing 10 points of damage!

The soot sprite falls over, gasping in pain. It drags itself off into the darkness.

Exits: west (Luminous Gardens) or down (Hall of Time)

>d
Hall of Time
A long, narrow hall, flickering with light from magefire sconces. The painted walls show the progression of time through planets and stars, sun and moons.

Exits: south (Nasty Passage) or up (Chilly Mausoleum)

>s
Nasty Passage
A tight squeeze between damp and slimy boulders. There is blood on the ground.

Exits: north (Hall of Time) or west (Jewelled Forest)

>w
Jewelled Forest
Marvellous columns march down the length of this immense cavern. Jewel-like lights shine from deep within.

Exits: north (Marble Halls) or east (Nasty Passage) or west (Cavern of the Lake of Tears)

>w
Cavern of the Lake of Tears
A still, deep lake stretches into the distance. It's vast. You can't see the other side.

Exits: south (Waterfall Cave) or east (Jewelled Forest)

>swim
The water feels great!
Ominous, like a grim battleship, you glide across the crystal waters.
You notice a little beach to the west.

Exits: south (Waterfall Cave) or east (Jewelled Forest) or west (Shorehaven)

>w
You get out of the water.

Shorehaven
A peaceful, secluded little beach, just the right size for a dungeon-going goose. A good place to tuck your head under your wing for a short nap.

Exits: north (Marble Halls) or east (Cavern of the Lake of Tears)

>e
Cavern of the Lake of Tears
A still, deep lake stretches into the distance. It's vast. You can't see the other side.

Exits: north (Vault of Vastness) or south (Waterfall Cave) or east (Jewelled Forest)

* * *

>d
You waddle valiantly forth.

The walls rumble. Rocks fall.
You can't see the sky anymore!
There is no way out.

Dungeon Entrance
Stone walls, mildewed with glowing stuff, widen into a large cold room. 

A large, colorful sign is on the wall.

You can see a healing potion and a trophy case (closed) here.

Exits: east (Rockslide Cavern)

>attack spider
You can't see any such thing.

>attack rat
You attack the giant rat, causing 4 points of damage!

The giant rat attacks you, causing 3 points of damage!

Exits: down (Uncanny Lair)

>kill rat
You attack the giant rat, causing 4 points of damage!

The giant rat falls over, gasping in pain. It drags itself off into the darkness.

Exits: down (Uncanny Lair)

* * *

>d
You waddle valiantly forth.

The walls rumble. Rocks fall.
You can't see the sky anymore!
There is no way out.

Dungeon Entrance
Stone walls, mildewed with glowing stuff, widen into a large cold room. 

A large, colorful sign is on the wall.

You can see a healing potion and a trophy case (closed) here.

Exits: east (Rockslide Cavern)

>d
You waddle on, nonchalant.

Glittering Shrine
Flecks of shining mica gleam from granite walls.

You can see a healing potion and an obsidian altar here.

Exits: north (Hall of Time) or up (Dungeon Entrance)

>d
Unvisted: Webby Corridor, Chamber of Lights, Waterfall Pool, Marble Halls, Lake of Tears, Jewelled Forest, Rockslide Cavern, Uncanny Lair and Den of Darkness.
Unpicked: Chamber of Lights, Waterfall Pool, Marble Halls, Lake of Tears, Jewelled Forest, Rockslide Cavern, Uncanny Lair and Den of Darkness.
~~~~ next room will be Marble Halls
available directions: north, south, east, west and down
available directions: north, south, east, west and down
~~~~ next direction will be south

Webby Corridor
You can see a gelatinous cube here.

Exits: south (Marble Halls) or up (Disturbing Hallway)

>s
Unvisted: Chamber of Lights, Waterfall Pool, Marble Halls, Lake of Tears, Jewelled Forest, Rockslide Cavern, Uncanny Lair and Den of Darkness.
Unpicked: Chamber of Lights, Waterfall Pool, Lake of Tears, Jewelled Forest, Rockslide Cavern, Uncanny Lair and Den of Darkness.
~~~~ next room will be Jewelled Forest
available directions: north, south, east, west and down
removing north because you just came from there 
available directions: south, east, west and down
~~~~ next direction will be west

Marble Halls
You can see a spider here.

Exits: north (Webby Corridor) or west (Jewelled Forest)

>w
Unvisted: Chamber of Lights, Waterfall Pool, Lake of Tears, Jewelled Forest, Rockslide Cavern, Uncanny Lair and Den of Darkness.
Unpicked: Chamber of Lights, Waterfall Pool, Lake of Tears, Rockslide Cavern, Uncanny Lair and Den of Darkness.
~~~~ next room will be Den of Darkness
available directions: north, south, east, west and down
removing east because you just came from there 
available directions: north, south, west and down
~~~~ next direction will be north

Jewelled Forest
You can see a giant bat here.

Exits: north (Den of Darkness) or east (Marble Halls)

>n
Unvisted: Chamber of Lights, Waterfall Pool, Lake of Tears, Rockslide Cavern, Uncanny Lair and Den of Darkness.
Unpicked: Chamber of Lights, Waterfall Pool, Lake of Tears, Rockslide Cavern and Uncanny Lair.
~~~~ next room will be Waterfall Pool
available directions: north, south, east, west and down
removing south because you just came from there 
available directions: north, east, west and down
~~~~ next direction will be west

Den of Darkness
Exits: south (Jewelled Forest) or west (Waterfall Pool)

>w
Unvisted: Chamber of Lights, Waterfall Pool, Lake of Tears, Rockslide Cavern and Uncanny Lair.
Unpicked: Chamber of Lights, Lake of Tears, Rockslide Cavern and Uncanny Lair.
~~~~ next room will be Uncanny Lair
available directions: north, south, east, west and down
removing east because you just came from there 
available directions: north, south, west and down
~~~~ next direction will be north

Waterfall Pool
Exits: north (Uncanny Lair) or east (Den of Darkness)

>n
Unvisted: Chamber of Lights, Lake of Tears, Rockslide Cavern and Uncanny Lair.
Unpicked: Chamber of Lights, Lake of Tears and Rockslide Cavern.
~~~~ next room will be Lake of Tears
available directions: north, south, east, west and down
removing south because you just came from there 
available directions: north, east, west and down
~~~~ next direction will be down

Uncanny Lair
Exits: south (Waterfall Pool) or down (Lake of Tears)

>d
Unvisted: Chamber of Lights, Lake of Tears and Rockslide Cavern.
Unpicked: Chamber of Lights and Rockslide Cavern.
~~~~ next room will be Rockslide Cavern
available directions: north, south, east, west and down
available directions: north, south, east, west and down
~~~~ next direction will be down

Lake of Tears
Exits: up (Uncanny Lair) or down (Rockslide Cavern)

>d
Unvisted: Chamber of Lights and Rockslide Cavern.
Unpicked: Chamber of Lights.
~~~~ next room will be Chamber of Lights
available directions: north, south, east, west and down
available directions: north, south, east, west and down
~~~~ next direction will be down

Rockslide Cavern
Exits: up (Lake of Tears) or down (Chamber of Lights)

>d
Unvisted: Chamber of Lights.
Unpicked: nothing.
You have reached a dead end.

Exits: up (Rockslide Cavern)

* * *

>d
You waddle on, nonchalant.

Glittering Shrine
Flecks of shining mica gleam from granite walls.

You can see a healing potion and an obsidian altar here.

Exits: north (Hall of Time) or up (Dungeon Entrance)

>e
Rockslide Cavern
Boulders have tumbled down on one side of this cave. It's a tight squeeze to get by them.

Exits: south (Hall of Time) or west (Webby Corridor)

>s
Hall of Time
A long, narrow hall, flickering with light from magefire sconces. The painted walls show the progression of time through planets and stars, sun and moons.

Exits: north (Rockslide Cavern) or down (Uncanny Lair)

* * *

>d
You waddle on, nonchalant.

Glittering Shrine
Flecks of shining mica gleam from granite walls.

You can see a healing potion and an obsidian altar here.

Exits: north (Hall of Time) or up (Dungeon Entrance)

>exits
That's not a verb I recognise.

* * *

>d
You waddle on, nonchalant.

Glittering Shrine
Flecks of shining mica gleam from granite walls.

You can see a healing potion and an obsidian altar here.

Exits: north (Hall of Time) or up (Dungeon Entrance)

>l
Dungeon Entrance

* * *

>d
You waddle on, nonchalant.

Glittering Shrine
Flecks of shining mica gleam from granite walls.

You can see a healing potion and an obsidian altar here.

Exits: north (Hall of Time) or up (Dungeon Entrance)

>n
Grunting with effort, you clamber over the rocky floor.

Hall of Time
A long, narrow hall, flickering with light from magefire sconces. The painted walls show the progression of time through planets and stars, sun and moons.

Exits: north (Webby Corridor) or south (Glittering Shrine)

>n
Owning that dungeon, lord of all you survey.

Webby Corridor
Dusty ropes of thick spiderweb festoon the walls. 
A brightly colored poster peeks out from beneath the webs.

You can see a cave snake here.

Exits: south (Hall of Time) or down (Den of Darkness)

>peck snake
You viciously peck the cave snake, causing 3 points of damage!
You viciously peck the cave snake, causing 8 points of damage!

The cave snake attacks you, causing 4 points of damage!

Exits: south (Hall of Time) or down (Den of Darkness)

>peck snake
You viciously peck the cave snake, causing 5 points of damage!

The cave snake trips and falls.
"Corporate headquarters didn't warn us about this!" it shrieks.
The cave snake drags itself off into the darkness.

Exits: south (Hall of Time) or down (Den of Darkness)

[Your score has just gone up by one point.]

>score
Your score is 1 out of a possible 12.
So far, you have defeated cave snake.

* * *

>n
Grunting with effort, you clamber over the rocky floor.

Hall of Time
A long, narrow hall, flickering with light from magefire sconces. The painted walls show the progression of time through planets and stars, sun and moons.

Exits: north (Webby Corridor) or south (Glittering Shrine)

>s
Unpicked: Webby Corridor, Chamber of Lights, Disturbing Hallway, Waterfall Cave, Marble Halls, Jewelled Forest, Rockslide Cavern, Uncanny Lair, Den of Darkness, Evil Archives, Luminous Gardens, Nasty Passage, Chilly Mausoleum and Hall of Time.

Vault of Vastness
Soaring arches overhead, stone display cases and cubbyholes in the walls. The treasure hall of a dragon, emptied of its loot.

Exits: north (Glittering Shrine) or up (Dungeon Entrance) or down (Waterfall Cave)

* * *

>d
You waddle on, nonchalant.

Glittering Shrine
Flecks of shining mica gleam from granite walls.

You can see a healing potion and an obsidian altar here.

Exits: north (Hall of Time) or up (Dungeon Entrance)

>s
Jewelled Forest
Exits: north (Marble Halls) or west (Evil Archives)

>n
~~~~ next room will be Den of Darkness
Cardinal directions: north, south, east, west and down
removing south because you just came from there 
~~~~ next direction will be down

Chamber of Lights
Exits: south or up or down

* * *

>s
Jewelled Forest
Exits: north (Marble Halls) or west (Evil Archives)

>w
Evil Archives
Exits: east (Jewelled Forest) or down (Chamber of Lights)

>d
Chamber of Lights
An uncanny mottled glow emanates from the walls of this high-ceilinged cavern.

You can see an iridium bat here.

Exits: up (Evil Archives) or down (Rockslide Cavern)

>d
Rockslide Cavern
Exits: south (Lake of Tears) or up (Chamber of Lights)

>s
You have reached a dead end.
Something stirs in the darkness.

Exits: north (Rockslide Cavern)

>look
Lake of Tears
You can see a sleeping dragon here.

Exits: north (Rockslide Cavern)

* * *

>w
Evil Archives
Exits: east (Jewelled Forest) or down (Chamber of Lights)

>s
Unvisted: Webby Corridor, Chamber of Lights, Waterfall Pool, Marble Halls, Lake of Tears, Rockslide Cavern and Den of Darkness.
Unpicked: Webby Corridor, Chamber of Lights, Waterfall Pool, Marble Halls, Lake of Tears, Rockslide Cavern and Den of Darkness.
~~~~ next room will be Chamber of Lights
~~~~ next direction will be east

Magnificent ruins
Crumbling stone, trees growing from crevices in the walls, and a narrow staircase leading down into darkness.

You can see a cave snake here.

Exits: north or east or down

>exits
You can go north (Jewelled Forest) or east (Chamber of Lights) or down (Dungeon Entrance) from here.

Exits: north or east or down

* * *

>d
You waddle on, nonchalant.

Glittering Shrine
Flecks of shining mica gleam from granite walls.

You can see a healing potion and an obsidian altar here.

Exits: north (Hall of Time) or up (Dungeon Entrance)

>up
You're going to a VISITED room.

Unvisted: Jewelled Forest, Cavern of the Lake of Tears, Shorehaven, Evil Archives, Librarian's Lair, Glittering Shrine, Vault of Secrets, Webby Corridor, Chamber of Lights, Disturbing Hallway, Waterfall Cave, Rockslide Cavern, Uncanny Lair, Den of Darkness, Luminous Gardens, Nasty Passage, Chilly Mausoleum, Hall of Time and Vault of Vastness
.
You are in Dungeon Entrance
The number of viable directions is 1.

Dungeon Entrance
Stone walls, mildewed with glowing stuff, widen into a large bare room.

You can see a giant rat and a trophy case (empty) here.

Exits: down (Marble Halls)

>d
Unvisted: Jewelled Forest, Cavern of the Lake of Tears, Shorehaven, Evil Archives, Librarian's Lair, Glittering Shrine, Vault of Secrets, Webby Corridor, Chamber of Lights, Disturbing Hallway, Waterfall Cave, Marble Halls, Rockslide Cavern, Uncanny Lair, Den of Darkness, Luminous Gardens, Nasty Passage, Chilly Mausoleum, Hall of Time and Vault of Vastness.

Exits: up (Dungeon Entrance)

>e
You can't go that way.

Exits: up (Dungeon Entrance)

* * *

>peck rat
You viciously peck the giant rat, causing 8 points of damage!

The giant rat falls over, gasping in pain.
"This isn't how things are supposed to go!" it mutters as it turns to run.
The giant rat drags itself off into the darkness.

Exits: down (Marble Halls)

>d
You're going to a VISITED room.

Unvisted: Jewelled Forest, Cavern of the Lake of Tears, Shorehaven, Evil Archives, Librarian's Lair, Glittering Shrine, Vault of Secrets, Webby Corridor, Chamber of Lights, Disturbing Hallway, Waterfall Cave, Rockslide Cavern, Uncanny Lair, Den of Darkness, Luminous Gardens, Nasty Passage, Chilly Mausoleum, Hall of Time and Vault of Vastness
.
You are in Marble Halls
The number of viable directions is 2.

Marble Halls
White flowstone gleams in thick curtains on the walls of this magnificent hall.

Exits: up (Dungeon Entrance) or down (Cavern of the Lake of Tears)

>d
Unvisted: Jewelled Forest, Cavern of the Lake of Tears, Shorehaven, Evil Archives, Librarian's Lair, Glittering Shrine, Vault of Secrets, Webby Corridor, Chamber of Lights, Disturbing Hallway, Waterfall Cave, Rockslide Cavern, Uncanny Lair, Den of Darkness, Luminous Gardens, Nasty Passage, Chilly Mausoleum, Hall of Time and Vault of Vastness
.
You are in Cavern of the Lake of Tears
The number of viable directions is 2.

Cavern of the Lake of Tears
A still, deep lake stretches into the distance. It's vast. You can't see the other side.

Exits: east (Jewelled Forest) or up (Marble Halls)

>swim
The water feels great!
Ominous, like a grim battleship, you glide across the crystal waters.

Exits: east (Jewelled Forest) or up (Marble Halls)

>w
You can't go that way.

Exits: east (Jewelled Forest) or up (Marble Halls)

>l
Cavern of the Lake of Tears
A still, deep lake stretches into the distance. It's vast. You can't see the other side.

Exits: east (Jewelled Forest) or up (Marble Halls)

* * *

>d
You waddle on, nonchalant.

Glittering Shrine
Flecks of shining mica gleam from granite walls.

You can see a healing potion and an obsidian altar here.

Exits: north (Hall of Time) or up (Dungeon Entrance)

>w
Unvisted: Webby Corridor, Chamber of Lights, Disturbing Hallway, Waterfall Pool, Marble Halls, Lake of Tears, Jewelled Forest, Rockslide Cavern and Den of Darkness.
Unpicked: Webby Corridor, Chamber of Lights, Disturbing Hallway, Waterfall Pool, Marble Halls, Lake of Tears, Jewelled Forest and Den of Darkness.
~~~~ next room will be Chamber of Lights
available directions: north, south, east, west and down
removing east because you just came from there 
available directions: north, south, west and down
~~~~ next direction will be down

Rockslide Cavern
You can see a kobold here.

Exits: east (Uncanny Lair) or down (Chamber of Lights)

>d
Unvisted: Webby Corridor, Chamber of Lights, Disturbing Hallway, Waterfall Pool, Marble Halls, Lake of Tears, Jewelled Forest and Den of Darkness.
Unpicked: Webby Corridor, Disturbing Hallway, Waterfall Pool, Marble Halls, Lake of Tears, Jewelled Forest and Den of Darkness.
~~~~ next room will be Webby Corridor
available directions: north, south, east, west and down
available directions: north, south, east, west and down
~~~~ next direction will be north

Chamber of Lights
You can see a giant bat here.

Exits: north (Webby Corridor) or up (Rockslide Cavern)

>n
Unvisted: Webby Corridor, Disturbing Hallway, Waterfall Pool, Marble Halls, Lake of Tears, Jewelled Forest and Den of Darkness.
Unpicked: Disturbing Hallway, Waterfall Pool, Marble Halls, Lake of Tears, Jewelled Forest and Den of Darkness.
~~~~ next room will be Waterfall Pool
available directions: north, south, east, west and down
removing south because you just came from there 
available directions: north, east, west and down
~~~~ next direction will be west

Webby Corridor
Exits: south (Chamber of Lights) or west (Waterfall Pool)

>w
Unvisted: Disturbing Hallway, Waterfall Pool, Marble Halls, Lake of Tears, Jewelled Forest and Den of Darkness.
Unpicked: Disturbing Hallway, Marble Halls, Lake of Tears, Jewelled Forest and Den of Darkness.
~~~~ next room will be Jewelled Forest
available directions: north, south, east, west and down
removing east because you just came from there 
available directions: north, south, west and down
~~~~ next direction will be north

Waterfall Pool
You can see a cave snake here.

Exits: north (Jewelled Forest) or east (Webby Corridor)

>n
Unvisted: Disturbing Hallway, Marble Halls, Lake of Tears, Jewelled Forest and Den of Darkness.
Unpicked: Disturbing Hallway, Marble Halls, Lake of Tears and Den of Darkness.
~~~~ next room will be Lake of Tears
available directions: north, south, east, west and down
removing south because you just came from there 
available directions: north, east, west and down
~~~~ next direction will be down

Jewelled Forest
You can see a gelatinous cube here.

Exits: south (Waterfall Pool) or down (Lake of Tears)

>d
Unvisted: Disturbing Hallway, Marble Halls, Lake of Tears and Den of Darkness.
Unpicked: Disturbing Hallway, Marble Halls and Den of Darkness.
~~~~ next room will be Marble Halls
available directions: north, south, east, west and down
available directions: north, south, east, west and down
~~~~ next direction will be north

Lake of Tears
Exits: north (Marble Halls) or up (Jewelled Forest)

>n
Unvisted: Disturbing Hallway, Marble Halls and Den of Darkness.
Unpicked: Disturbing Hallway and Den of Darkness.
~~~~ next room will be Den of Darkness
available directions: north, south, east, west and down
removing south because you just came from there 
available directions: north, east, west and down
~~~~ next direction will be north

Marble Halls
Exits: north (Den of Darkness) or south (Lake of Tears)

>n
Unvisted: Disturbing Hallway and Den of Darkness.
Unpicked: Disturbing Hallway.
~~~~ next room will be Disturbing Hallway
available directions: north, south, east, west and down
removing south because you just came from there 
available directions: north, east, west and down
~~~~ next direction will be west

Den of Darkness
Exits: south (Marble Halls) or west (Disturbing Hallway)

>w
Unvisted: Disturbing Hallway.
Unpicked: nothing.

Exits: east (Den of Darkness)

>exits
You can go east (Den of Darkness) from here.

Exits: east (Den of Darkness)

>w
You can't go that way.

Exits: east (Den of Darkness)

>e
Unvisted: Disturbing Hallway.
Unpicked: nothing.

Exits: south (Marble Halls) or west (Disturbing Hallway)

>l
Den of Darkness
Exits: south (Marble Halls) or west (Disturbing Hallway)

>w
Unvisted: Disturbing Hallway.
Unpicked: nothing.

Exits: east (Den of Darkness)

>l
Disturbing Hallway
Exits: east (Den of Darkness)

* * *

>d
You waddle valiantly forth.

The walls rumble. Rocks fall.
You can't see the sky anymore!
There is no way out.

Dungeon Entrance
Stone walls, mildewed with glowing stuff, widen into a large cold room. 

A large, colorful sign is on the wall.

You can see a healing potion and a trophy case (closed) here.

Exits: east (Rockslide Cavern)

>drink potion
(first taking the healing potion)
You feel more vigorous!

Exits: down (Webby Corridor)

* * *

>d
You waddle valiantly forth.

The walls rumble. Rocks fall.
You can't see the sky anymore!
There is no way out.

Dungeon Entrance
Stone walls, mildewed with glowing stuff, widen into a large cold room. 

A large, colorful sign is on the wall.

You can see a healing potion and a trophy case (closed) here.

Exits: east (Rockslide Cavern)

>e
Your broad foot webs slappity-slap across the dungeon floor.

Rockslide Cavern
Boulders have tumbled down on one side of this cave. It's a tight squeeze to get by them.

You can see a vial of coffee and a tentacled horror here.

Exits: west (Dungeon Entrance) or down (Luminous Gardens)

>d
You waddle on, nonchalant.

Luminous Gardens
Mushrooms the size of trees, glowing, are scattered among winding paths. Tiny lightning bugs flit between snow-pale cave blossoms.

You can see a healing potion and a wispy ghost here.

Exits: east (Den of Darkness) or up (Rockslide Cavern)

>d
~~~~ next room will be Den of Darkness
Cardinal directions: north, south, east, west and down
Available directions: north, south, east, west and down
~~~~ next direction will be south

Jewelled Forest
Exits: south or up

>s
~~~~ next room will be Lake of Tears
Cardinal directions: north, south, east, west and down
Available directions: south, east, west and down
~~~~ next direction will be south

Den of Darkness
You can see a gelatinous cube here.

Exits: north or south

>s
~~~~ next room will be Disturbing Hallway
Cardinal directions: north, south, east, west and down
Available directions: south, east, west and down
~~~~ next direction will be north

Lake of Tears
Exits: north

>exits
You can go north (Disturbing Hallway) from here.

Exits: north

>s
You can't go that way.

Exits: north

>n
~~~~ next room will be Uncanny Lair
Cardinal directions: north, south, east, west and down
Available directions: north, east, west and down
~~~~ next direction will be east

Disturbing Hallway
You can see a giant bat here.

Exits: south or east

>e
~~~~ next room will be Waterfall Pool
Cardinal directions: north, south, east, west and down
Available directions: north, south, east and down
~~~~ next direction will be north

Uncanny Lair
Exits: north or west

>n
~~~~ next room will be Webby Corridor
Cardinal directions: north, south, east, west and down
Available directions: north, east, west and down
~~~~ next direction will be east

Waterfall Pool
Exits: south or east

>e
~~~~ next room will be Rockslide Cavern
Cardinal directions: north, south, east, west and down
Available directions: north, south, east and down
~~~~ next direction will be north

Webby Corridor
Exits: north or west

>n
~~~~ next room will be nothing
Cardinal directions: north, south, east, west and down
Available directions: north, east, west and down
~~~~ next direction will be west

[** Programming error: tried to find the "." of (something) **]

[** Programming error: tried to find the "." of (something) **]

Rockslide Cavern
Exits: south

* * *

>d
You waddle on, nonchalant.

Luminous Gardens
Mushrooms the size of trees, glowing, are scattered among winding paths. Tiny lightning bugs flit between snow-pale cave blossoms.

You can see a healing potion and a wispy ghost here.

Exits: east (Den of Darkness) or up (Rockslide Cavern)

>exits
You can go west (Chamber of Lights) or up (Rockslide Cavern) from here.

Exits: west or up

* * *

>d
You waddle on, nonchalant.

Luminous Gardens
Mushrooms the size of trees, glowing, are scattered among winding paths. Tiny lightning bugs flit between snow-pale cave blossoms.

You can see a healing potion and a wispy ghost here.

Exits: east (Den of Darkness) or up (Rockslide Cavern)

>peck ghost
You viciously peck the wispy ghost, causing 4 points of damage!
You viciously peck the wispy ghost, causing 4 points of damage!

The wispy ghost attacks you, causing 3 points of damage!

Exits: east (Den of Darkness) or up (Rockslide Cavern)

>peck ghost
You viciously peck the wispy ghost, causing 6 points of damage!

The wispy ghost leaps back in shock.
"Ow, that's going too far!" it whines, cringing.
The wispy ghost drags itself off into the darkness.

Exits: east (Den of Darkness) or up (Rockslide Cavern)

[Your score has just gone up by one point.]

>e
Your beady-eyed glance darts across yet another corridor.

Den of Darkness
The darkness softens, the room is hushed. It's hard to see your way out.

You can see an AirDnD headlamp and a giant rat here.

Exits: west (Luminous Gardens) or down (Disturbing Hallway)

>peck rat
You viciously peck the giant rat, causing 5 points of damage!
You viciously peck the giant rat, causing 6 points of damage!

The giant rat leaps back in shock.
"AirDnD sucks! Worst job ever!" it mutters.
The giant rat drags itself off into the darkness.

Exits: west (Luminous Gardens) or down (Disturbing Hallway)

[Your score has just gone up by one point.]

>score
Your score is 2 out of a possible 12.
So far, you have defeated giant rat and wispy ghost.

* * *

>d
You waddle on, nonchalant.

Luminous Gardens
Mushrooms the size of trees, glowing, are scattered among winding paths. Tiny lightning bugs flit between snow-pale cave blossoms.

You can see a healing potion and a wispy ghost here.

Exits: east (Den of Darkness) or up (Rockslide Cavern)

>s
Attempting stealth, you stretch out your long and graceful neck.

Evil Archives
Row upon row of moldering tomes, dust, and a sense of forboding fill this underground library.

You can see AirDnD platemail, a vial of coffee and a gelatinous cube here.

Exits: north (Den of Darkness) or down (Luminous Gardens)

>d
You waddle valiantly forth.

Luminous Gardens
Mushrooms the size of trees, glowing, are scattered among winding paths. Tiny lightning bugs flit between snow-pale cave blossoms.

You can see an AirDnD lanyard and a vial of coffee here.

Exits: north (Webby Corridor) or up (Evil Archives)

>n
Grunting with effort, you clamber over the rocky floor.

Webby Corridor
Dusty ropes of thick spiderweb festoon the walls. 
A brightly colored poster peeks out from beneath the webs.

You can see a lumbering mummy here.

Exits: south (Luminous Gardens) or east (Chilly Mausoleum)

>e
You waddle valiantly forth.

Chilly Mausoleum
Cold seeps into your bones. Faceless tombs loom overhead. 
A tacky orange and green painting hangs on the wall.

Exits: west (Webby Corridor) or down (Waterfall Cave)

>d
Your broad foot webs slappity-slap across the dungeon floor.

Waterfall Cave
Water pours down from high above, catching on stalactites and glinting in the eerie glow from the walls. A little pool lies underneath.

You can see an amulet of awesome here.

Exits: south (Cavern of the Lake of Tears) or up (Chilly Mausoleum)

>s
Owning that dungeon, lord of all you survey.

Cavern of the Lake of Tears
A still, deep lake stretches into the distance. It's vast. You can't see the other side.

You can see a healing potion and an iridium bat here.

Exits: north (Waterfall Cave) or west (Chamber of Lights)

>w
Hissing a little, you peer from side to side.

Chamber of Lights
An uncanny mottled glow emanates from the walls of this high-ceilinged cavern. 
An orange and green motto, made of eerie light, floats in the air.

You can see a tentacled horror here.

Exits: north (Nasty Passage) or east (Cavern of the Lake of Tears)

>n
Grunting with effort, you clamber over the rocky floor.

Nasty Passage
A tight squeeze between damp and slimy boulders. There is blood on the ground.

Exits: south (Chamber of Lights) or west (Jewelled Forest)

>w
Your beady-eyed glance darts across yet another corridor.

Jewelled Forest
Marvellous columns march down the length of this immense cave. Jewel-like lights shine from deep within.

You can see a grumpy kobold here.

Exits: east (Nasty Passage) or down (Uncanny Lair)

>d
Your broad foot webs slappity-slap across the dungeon floor.

Uncanny Lair
Oddly shaped bones are strewn about this rough cave. Some creature made a nest in one corner out of shredded fungus.

Exits: west (Disturbing Hallway) or up (Jewelled Forest)

>w
Your beady-eyed glance darts across yet another corridor.

Disturbing Hallway
The angles here, the colors, the feel of the air -- just wrong. Horribly wrong.

You can see a giant rat here.

Exits: north (Rockslide Cavern) or east (Uncanny Lair)

>n
You waddle valiantly forth.

Rockslide Cavern
Boulders have tumbled down on one side of this cave. It's a tight squeeze to get by them.

You can see a diamond tiara here.

Exits: south (Disturbing Hallway) or east (Glittering Shrine)

>e
Grimly, you forge ever onward, tail waggling.

Glittering Shrine
Flecks of shining mica gleam from granite walls.

You can see a glittering cloak, a spider and an obsidian altar here.

Exits: west (Rockslide Cavern) or down (Marble Halls)

>d
Your beady-eyed glance darts across yet another corridor.

You have reached a dead end.
Something stirs in the darkness.

Marble Halls
White flowstone gleams in thick curtains on the walls of this magnificent hall. 

You can see a rainbow dragon and a torn parchment here.

Exits: up (Glittering Shrine)

>take parchment
Taken.

Exits: up (Glittering Shrine)

>x parchment
It's dusty, smudged, and looks like it's been folded up in someone's pocket for a while. It reads,

Dear Gnarf, 
   How's things back at the village? I'm not doing so good. I took the AirDnD gig. Only place in the realm that would take me with no references. Avoid if if you can. They WATCH you, all the time, we can't tell how, so you can't even take a little nap on a slow day. Every once in a while, you get a creepy voice out of nowhere telling you to move to some different location in the dungeon. 
   And this dungeon, I swear to Sfigplatz, it's cold, it's dirty, it's wet, there's nowhere to pee and no break room, we just stand around all day. It's impossible to get around, sometimes we can't even leave, because whenever they move us to a new cavern, all the rooms seem to have been changed around! Anyway, I hear a noise, someone coming, must.... ARRRRRRGH!!!

 The letter ends here, as a splotch of greenish ichor seems to have burned the parchment away.

Exits: up (Glittering Shrine)

* * *

>d
You waddle on, nonchalant.

Luminous Gardens
Mushrooms the size of trees, glowing, are scattered among winding paths. Tiny lightning bugs flit between snow-pale cave blossoms.

You can see a healing potion and a wispy ghost here.

Exits: east (Den of Darkness) or up (Rockslide Cavern)

>up
Unvisted: Jewelled Forest, Cavern of the Lake of Tears, Shorehaven, Evil Archives, Librarian's Lair, Glittering Shrine, Vault of Secrets, Webby Corridor, Disturbing Hallway, Waterfall Cave, Marble Halls, Uncanny Lair, Den of Darkness, Luminous Gardens, Nasty Passage, Chilly Mausoleum, Hall of Time and Vault of Vastness.
Unpicked: Jewelled Forest, Evil Archives, Glittering Shrine, Webby Corridor, Disturbing Hallway, Waterfall Cave, Marble Halls, Uncanny Lair, Den of Darkness, Luminous Gardens, Nasty Passage, Chilly Mausoleum and Hall of Time.
~~~~ next room will be Marble Halls
available directions: north, south, east, west and down
removing west because you just came from there 
removing down because you just came from there 
available directions: north, south and east
~~~~ next direction will be north

Rockslide Cavern
Boulders have tumbled down on one side of this cave. It's a tight squeeze to get by them.

You can see a spider and a confused adventurer here.

Exits: north (Marble Halls) or west (Dungeon Entrance) or down (Chamber of Lights)

>w
Unvisted: Jewelled Forest, Cavern of the Lake of Tears, Shorehaven, Evil Archives, Librarian's Lair, Glittering Shrine, Vault of Secrets, Webby Corridor, Disturbing Hallway, Waterfall Cave, Marble Halls, Uncanny Lair, Den of Darkness, Luminous Gardens, Nasty Passage, Chilly Mausoleum, Hall of Time and Vault of Vastness.
Unpicked: Jewelled Forest, Evil Archives, Glittering Shrine, Webby Corridor, Disturbing Hallway, Waterfall Cave, Marble Halls, Uncanny Lair, Den of Darkness, Luminous Gardens, Nasty Passage, Chilly Mausoleum and Hall of Time.
~~~~ next room will be Chilly Mausoleum
available directions: north, south, east, west and down
available directions: north, south, east, west and down
~~~~ next direction will be down

Dungeon Entrance
Stone walls, mildewed with glowing stuff, widen into a large bare room.

You can see a glowering elf, a giant rat and a trophy case (empty) here.

Exits: east (Rockslide Cavern) or down (Chilly Mausoleum)

>peck rat
You viciously peck the giant rat, causing 4 points of damage!
You viciously peck the giant rat, causing 3 points of damage!

The giant rat trips and falls.
"Ouch! I'm out of here!" it yells.
The giant rat drags itself off into the darkness.

Exits: east (Rockslide Cavern) or down (Chilly Mausoleum)

>e
Unvisted: Jewelled Forest, Cavern of the Lake of Tears, Shorehaven, Evil Archives, Librarian's Lair, Glittering Shrine, Vault of Secrets, Webby Corridor, Disturbing Hallway, Waterfall Cave, Marble Halls, Uncanny Lair, Den of Darkness, Luminous Gardens, Nasty Passage, Chilly Mausoleum, Hall of Time and Vault of Vastness.
Unpicked: Jewelled Forest, Evil Archives, Glittering Shrine, Webby Corridor, Disturbing Hallway, Waterfall Cave, Marble Halls, Uncanny Lair, Den of Darkness, Luminous Gardens, Nasty Passage, Chilly Mausoleum and Hall of Time.
~~~~ next room will be Chilly Mausoleum
available directions: north, south, east, west and down
removing north because you just came from there 
removing west because you just came from there 
removing down because you just came from there 
available directions: south and east
~~~~ next direction will be south

Rockslide Cavern
Boulders have tumbled down on one side of this cave. It's a tight squeeze to get by them.

You can see a soot sprite, a spider and a confused adventurer here.

Exits: north (Marble Halls) or south (Chilly Mausoleum) or west (Dungeon Entrance) or down (Chamber of Lights)

* * *

>e
Your broad foot webs slappity-slap across the dungeon floor.

Rockslide Cavern
Boulders have tumbled down on one side of this cave. It's a tight squeeze to get by them.

You can see a vial of coffee and a tentacled horror here.

Exits: west (Dungeon Entrance) or down (Luminous Gardens)

>e
Unvisted: Jewelled Forest, Cavern of the Lake of Tears, Shorehaven, Evil Archives, Librarian's Lair, Glittering Shrine, Vault of Secrets, Webby Corridor, Chamber of Lights, Disturbing Hallway, Waterfall Cave, Rockslide Cavern, Uncanny Lair, Den of Darkness, Luminous Gardens, Nasty Passage, Chilly Mausoleum, Hall of Time and Vault of Vastness
.
You are in Glittering Shrine
You are in Glittering Shrine for the FIRST time
Unpicked: Jewelled Forest, Evil Archives, Webby Corridor, Chamber of Lights, Disturbing Hallway, Waterfall Cave, Rockslide Cavern, Uncanny Lair, Den of Darkness, Luminous Gardens, Nasty Passage, Chilly Mausoleum and Hall of Time.
~~~~ next room will be Chamber of Lights
available directions: north, south, east, west and down
removing west because you just came from there 
available directions: north, south, east and down
~~~~ next direction will be north

Glittering Shrine
Flecks of shining mica gleam from granite walls.

You can see a spider and an obsidian altar here.

Exits: north (Chamber of Lights) or west (Marble Halls)

>w
You're going to a VISITED room.

Unvisted: Jewelled Forest, Cavern of the Lake of Tears, Shorehaven, Evil Archives, Librarian's Lair, Vault of Secrets, Webby Corridor, Chamber of Lights, Disturbing Hallway, Waterfall Cave, Rockslide Cavern, Uncanny Lair, Den of Darkness, Luminous Gardens, Nasty Passage, Chilly Mausoleum, Hall of Time and Vault of Vastness
.
You are in Marble Halls

Exits: east (Glittering Shrine) or west (Dungeon Entrance)

* * *

>e
Your broad foot webs slappity-slap across the dungeon floor.

Rockslide Cavern
Boulders have tumbled down on one side of this cave. It's a tight squeeze to get by them.

You can see a vial of coffee and a tentacled horror here.

Exits: west (Dungeon Entrance) or down (Luminous Gardens)

>exits
You can go north (Chamber of Lights) or west (Dungeon Entrance) from here.

Exits: north or west

>n
~~~~ next room will be Jewelled Forest
Cardinal directions: north, south, east, west and down
removing south because you just came from there 
Available directions: north, east, west and down
~~~~ next direction will be south

Chamber of Lights
Exits: south

* * *

>e
Your broad foot webs slappity-slap across the dungeon floor.

Rockslide Cavern
Boulders have tumbled down on one side of this cave. It's a tight squeeze to get by them.

You can see a vial of coffee and a tentacled horror here.

Exits: west (Dungeon Entrance) or down (Luminous Gardens)

>n
~~~~ next room will be Den of Darkness
available directions: north, south, east, west and down
removing south because you just came from there 
available directions: north, east, west and down
~~~~ next direction will be north

Lake of Tears
Exits: north (Den of Darkness) or south (Marble Halls)

>n
~~~~ next room will be Disturbing Hallway
available directions: north, south, east, west and down
removing south because you just came from there 
available directions: north, east, west and down
~~~~ next direction will be north

Den of Darkness
You can see a spider here.

Exits: north (Disturbing Hallway) or south (Lake of Tears)

>n
~~~~ next room will be Waterfall Pool
available directions: north, south, east, west and down
removing south because you just came from there 
available directions: north, east, west and down
~~~~ next direction will be north

Disturbing Hallway
Exits: north (Waterfall Pool) or south (Den of Darkness)

>n
~~~~ next room will be Uncanny Lair
available directions: north, south, east, west and down
removing south because you just came from there 
available directions: north, east, west and down
~~~~ next direction will be down

Waterfall Pool
You can see a cave snake here.

Exits: south (Disturbing Hallway) or down (Uncanny Lair)

>d
~~~~ next room will be Webby Corridor
available directions: north, south, east, west and down
available directions: north, south, east, west and down
~~~~ next direction will be north

Uncanny Lair
You can see a kobold here.

Exits: north (Webby Corridor) or up (Waterfall Pool)

>n
~~~~ next room will be Chamber of Lights
available directions: north, south, east, west and down
removing south because you just came from there 
available directions: north, east, west and down
~~~~ next direction will be north

Webby Corridor
You can see a gelatinous cube here.

Exits: north (Chamber of Lights) or south (Uncanny Lair)

>n
~~~~ next room will be Rockslide Cavern
available directions: north, south, east, west and down
removing south because you just came from there 
available directions: north, east, west and down
~~~~ next direction will be north

Chamber of Lights
Exits: north (Rockslide Cavern) or south (Webby Corridor)

>n
~~~~ next room will be Jewelled Forest
available directions: north, south, east, west and down
removing south because you just came from there 
available directions: north, east, west and down
~~~~ next direction will be down

Rockslide Cavern
Exits: south (Chamber of Lights) or down (Jewelled Forest)

>d
Exits: up (Rockslide Cavern)

>exits
You can go up (Rockslide Cavern) from here.

Exits: up (Rockslide Cavern)

* * *

>e
Your broad foot webs slappity-slap across the dungeon floor.

Rockslide Cavern
Boulders have tumbled down on one side of this cave. It's a tight squeeze to get by them.

You can see a vial of coffee and a tentacled horror here.

Exits: west (Dungeon Entrance) or down (Luminous Gardens)

>s
Unvisted: Jewelled Forest, Cavern of the Lake of Tears, Shorehaven, Evil Archives, Librarian's Lair, Glittering Shrine, Vault of Secrets, Webby Corridor, Chamber of Lights, Disturbing Hallway, Waterfall Cave, Rockslide Cavern, Uncanny Lair, Den of Darkness, Luminous Gardens, Nasty Passage, Chilly Mausoleum, Hall of Time and Vault of Vastness.
Unpicked: Jewelled Forest, Evil Archives, Glittering Shrine, Webby Corridor, Chamber of Lights, Disturbing Hallway, Waterfall Cave, Rockslide Cavern, Den of Darkness, Luminous Gardens, Nasty Passage, Chilly Mausoleum and Hall of Time.
~~~~ next room will be Chilly Mausoleum
available directions: north, south, east, west and down
removing north because you just came from there 
available directions: south, east, west and down
~~~~ next direction will be east

Uncanny Lair
Oddly shaped bones are strewn about this rough cave. Some creature made a nest in one corner out of shredded fungus.

Exits: north (Marble Halls) or east (Chilly Mausoleum)

>d
Evil Archives
You can see an iridium bat here.

Exits: east (Marble Halls) or up (Vault of Vastness)

>e
Marble Halls
White flowstone gleams in thick curtains on the walls of this magnificent hall.

Exits: east (Glittering Shrine) or west (Evil Archives)

>e
Glittering Shrine
Exits: west (Marble Halls) or down (Luminous Gardens)

>d
Luminous Gardens
Exits: south (Crumbling Corridor) or up (Glittering Shrine)

>s
Crumbling Corridor
You can see a soot sprite here.

Exits: north (Luminous Gardens) or west (Disturbing Hallway)

>w
Disturbing Hallway
The angles here, the colors, the feel of the air -- just wrong. Horribly wrong.

You can see a tentacled horror here.

Exits: north (Chamber of Lights) or east (Crumbling Corridor)

>n
Chamber of Lights
An uncanny mottled glow emanates from the walls of this high-ceilinged cavern.

You can see a kobold here.

Exits: south (Disturbing Hallway) or east (Webby Corridor)

>e
Webby Corridor
Dusty ropes of thick spiderweb festoon the walls.

You can see a cave snake here.

Exits: south (Waterfall Cave) or west (Chamber of Lights)

>s
Waterfall Cave
Water pours down from high above, catching on stalactites and glinting in the eerie glow from the walls. A little pool lies underneath.

You can see a gelatinous cube here.

Exits: north (Webby Corridor) or south (Jewelled Forest)

>swim
The water feels great!
Ominous, like a grim battleship, you glide across the crystal waters.

Exits: north (Webby Corridor) or south (Jewelled Forest)

>n
You get out of the water.

Webby Corridor
Dusty ropes of thick spiderweb festoon the walls.

You can see a glowering elf and a cave snake here.

Exits: south (Waterfall Cave) or east (Den of Darkness) or west (Chamber of Lights)

>w
Chamber of Lights
An uncanny mottled glow emanates from the walls of this high-ceilinged cavern.

You can see a spider and a kobold here.

Exits: north (Chilly Mausoleum) or south (Disturbing Hallway) or east (Webby Corridor)

>e
Webby Corridor
Dusty ropes of thick spiderweb festoon the walls.

You can see a lumbering mummy, a glowering elf and a cave snake here.

Exits: north (Rockslide Cavern) or south (Waterfall Cave) or east (Den of Darkness) or west (Chamber of Lights)

>e
Den of Darkness
Exits: west (Webby Corridor) or down (Chilly Mausoleum)

>d
Chilly Mausoleum
You can see a wispy ghost here.

Exits: south (Chamber of Lights) or east (Hall of Time) or up (Den of Darkness)

>s
Chamber of Lights
An uncanny mottled glow emanates from the walls of this high-ceilinged cavern.

You can see a spider and a kobold here.

Exits: north (Chilly Mausoleum) or south (Disturbing Hallway) or east (Webby Corridor) or down (Rockslide Cavern)

>d
Rockslide Cavern
Exits: south (Webby Corridor) or up (Chamber of Lights) or down (Nasty Passage)

>d
Nasty Passage
Exits: south (Jewelled Forest) or up (Rockslide Cavern)

>s
Jewelled Forest
Exits: north (Nasty Passage) or south (Hall of Time) or west (Cavern of the Lake of Tears)

>w
Cavern of the Lake of Tears
A still, deep lake stretches into the distance. It's vast. You can't see the other side.

Exits: south (Hall of Time) or east (Jewelled Forest) or west (Shorehaven)

>swim
The water feels great!
Ominous, like a grim battleship, you glide across the crystal waters.
You notice a little beach to the west.

Exits: south (Hall of Time) or east (Jewelled Forest) or west (Shorehaven)

* * *

>e
Exits are: west (Marble Halls)
next room will be Webby Corridor
next direction will be up

Chamber of Lights

>up
Exits are: down (Chamber of Lights)
next room will be Disturbing Hallway
next direction will be up

Webby Corridor

* * *

>exits
You can go north (Webby Corridor) from here.

Exits: north

* * *

>n
Unvisted: Jewelled Forest, Cavern of the Lake of Tears, Shorehaven, Evil Archives, Librarian's Lair, Glittering Shrine, Vault of Secrets, Webby Corridor, Chamber of Lights, Disturbing Hallway, Waterfall Cave, Rockslide Cavern, Den of Darkness, Luminous Gardens, Nasty Passage, Chilly Mausoleum, Hall of Time and Vault of Vastness.
Unpicked: Jewelled Forest, Evil Archives, Glittering Shrine, Webby Corridor, Chamber of Lights, Disturbing Hallway, Waterfall Cave, Rockslide Cavern, Den of Darkness, Luminous Gardens, Nasty Passage, Chilly Mausoleum and Hall of Time.
~~~~ next room will be Glittering Shrine
available directions: north, south, east, west and down
removing south because you just came from there 
removing west because you just came from there 
available directions: north, east and down
~~~~ next direction will be east

Marble Halls
White flowstone gleams in thick curtains on the walls of this magnificent hall.

Exits: south (Uncanny Lair) or east (Glittering Shrine) or west (Dungeon Entrance)

* * *

>swim
Ominous, like a grim battleship, you glide across the crystal waters.

Exits: north (Jewelled Forest) or west (Chamber of Lights)

>n
Jewelled Forest
You can see a tentacled horror and a glowering elf here.

Exits: south (Waterfall Cave) or west (Dungeon Entrance) or down (Crumbling Corridor)

* * *

>w
Waterfall Pool
Water pours down from high above, catching on stalactites and glinting in the eerie glow from the walls. A little pool lies underneath.

Exits: east (Vault of Vastness) or down (Uncanny Lair)

>d
Uncanny Lair
You can see a kobold here.

Exits: east (Glittering Shrine) or up (Waterfall Pool)

>up
Waterfall Pool
Water pours down from high above, catching on stalactites and glinting in the eerie glow from the walls. A little pool lies underneath.

You can see a lumbering mummy here.

Exits: north (Marble Halls) or east (Vault of Vastness) or down (Uncanny Lair)

>swim
You must supply a noun.

Exits: north (Marble Halls) or east (Vault of Vastness) or down (Uncanny Lair)

>swim in pool
I only understood you as far as wanting to swim.

>swim pool
I only understood you as far as wanting to swim.

* * *

>e
Your broad foot webs slappity-slap across the dungeon floor.

Rockslide Cavern
Boulders have tumbled down on one side of this cave. It's a tight squeeze to get by them.

You can see a vial of coffee and a tentacled horror here.

Exits: west (Dungeon Entrance) or down (Luminous Gardens)

>up
Exits are: down (Waterfall Pool)
next room will be Webby Corridor
next direction will be northeast

Marble Halls

>ne
Exits are: southwest (Marble Halls)
next room will be Lake of Tears
next direction will be up

Webby Corridor

>up
Exits are: down (Webby Corridor)
next room will be Disturbing Hallway
next direction will be east

Lake of Tears

>e
Exits are: west (Lake of Tears)
next room will be Disturbing Hallway
next direction will be southeast

Disturbing Hallway

>se
Exits are: northwest (Disturbing Hallway) or southeast (Disturbing Hallway) or west (Lake of Tears)
next room will be Chamber of Lights
next direction will be northwest

Disturbing Hallway

>nw
Exits are: southeast (Disturbing Hallway)
next room will be Chamber of Lights
next direction will be south

Chamber of Lights

>s
Exits are: north (Chamber of Lights) or south (Chamber of Lights) or southeast (Disturbing Hallway)
next room will be nothing
next direction will be southwest

[** Programming error: tried to find the "." of (something) **]

[** Programming error: tried to find the "." of (something) **]

Chamber of Lights

* * *

>e
Your broad foot webs slappity-slap across the dungeon floor.

Rockslide Cavern
Boulders have tumbled down on one side of this cave. It's a tight squeeze to get by them.

You can see a vial of coffee and a tentacled horror here.

Exits: west (Dungeon Entrance) or down (Luminous Gardens)

>w
You're going to a VISITED room.

You are in Dungeon Entrance
The number of viable directions is 1.

Dungeon Entrance
Stone walls, mildewed with glowing stuff, widen into a large bare room.

You can see a confused adventurer, a giant rat and a trophy case (empty) here.

Exits: east (Chilly Mausoleum)

>e
You're going to a VISITED room.

You are in Chilly Mausoleum
The number of viable directions is 2.

Chilly Mausoleum
Cold seeps into your bones. Faceless tombs loom overhead.

Exits: west (Dungeon Entrance) or down (Waterfall Cave)

>d
You are in Waterfall Cave
The number of viable directions is 1.
You are in Waterfall Cave for the FIRST time
~~~~ next room will be Glittering Shrine
available directions: north, south, east, west and down
~~~~ next direction will be north

Waterfall Cave
Water pours down from high above, catching on stalactites and glinting in the eerie glow from the walls. A little pool lies underneath.

Exits: north (Glittering Shrine) or up (Chilly Mausoleum)

>n
You are in Glittering Shrine
The number of viable directions is 1.
You are in Glittering Shrine for the FIRST time
~~~~ next room will be Evil Archives
available directions: north, south, east, west and down
removing south because you just came from there 
~~~~ next direction will be west

Glittering Shrine
Flecks of shining mica gleam from granite walls.

You can see a gelatinous cube and an obsidian altar here.

Exits: south (Waterfall Cave) or west (Evil Archives)

>w
You are in Evil Archives
The number of viable directions is 1.
You are in Evil Archives for the FIRST time
~~~~ next room will be Den of Darkness
available directions: north, south, east, west and down
removing east because you just came from there 
~~~~ next direction will be down

Evil Archives
Row upon row of moldering tomes, dust, and a sense of forboding fill this underground library.

Exits: east (Glittering Shrine) or down (Den of Darkness)

>d
You are in Den of Darkness
The number of viable directions is 1.
You are in Den of Darkness for the FIRST time
~~~~ next room will be Luminous Gardens
available directions: north, south, east, west and down
~~~~ next direction will be north

Den of Darkness
The darkness softens, the room is hushed. It's hard to see your way out.

Exits: north (Luminous Gardens) or up (Evil Archives)

>up
You're going to a VISITED room.

You are in Evil Archives
The number of viable directions is 2.

Evil Archives
Row upon row of moldering tomes, dust, and a sense of forboding fill this underground library.

Exits: east (Glittering Shrine) or down (Den of Darkness)

>d
You're going to a VISITED room.

You are in Den of Darkness
The number of viable directions is 2.

Den of Darkness
The darkness softens, the room is hushed. It's hard to see your way out.

Exits: north (Luminous Gardens) or up (Evil Archives)

>n
You are in Luminous Gardens
The number of viable directions is 1.
You are in Luminous Gardens for the FIRST time
~~~~ next room will be Nasty Passage
available directions: north, south, east, west and down
removing south because you just came from there 
~~~~ next direction will be east

Luminous Gardens
Mushrooms the size of trees, glowing, are scattered among winding paths. Tiny lightning bugs flit between snow-pale cave blossoms.

Exits: south (Den of Darkness) or east (Nasty Passage)

>e
You are in Nasty Passage
The number of viable directions is 1.
You are in Nasty Passage for the FIRST time
~~~~ next room will be Uncanny Lair
available directions: north, south, east, west and down
removing west because you just came from there 
~~~~ next direction will be east

Nasty Passage
A tight squeeze between damp and slimy boulders. There is blood on the ground.

You can see a tentacled horror here.

Exits: east (Uncanny Lair) or west (Luminous Gardens)

>e
You are in Uncanny Lair
The number of viable directions is 1.
You are in Uncanny Lair for the FIRST time
~~~~ next room will be Hall of Time
available directions: north, south, east, west and down
removing west because you just came from there 
~~~~ next direction will be south

Uncanny Lair
Oddly shaped bones are strewn about this rough cave. Some creature made a nest in one corner out of shredded fungus.

You can see a soot sprite here.

Exits: south (Hall of Time) or west (Nasty Passage)

>peck sprite
You viciously peck the soot sprite, causing 6 points of damage!
You viciously peck the soot sprite, causing 6 points of damage!

The soot sprite trips and falls.
"Scare the adventurers, they said, it's easy, they said," it shrieks.
The soot sprite drags itself off into the darkness.

Exits: south (Hall of Time) or west (Nasty Passage)

>s
You are in the Hall of Time
The number of viable directions is 1.
You are in the Hall of Time for the FIRST time
~~~~ next room will be Rockslide Cavern
available directions: north, south, east, west and down
removing north because you just came from there 
~~~~ next direction will be south

Hall of Time
A long, narrow hall, flickering with light from magefire sconces. The painted walls show the progression of time through planets and stars, sun and moons.

Exits: north (Uncanny Lair) or south (Rockslide Cavern)

* * *

>d
You waddle valiantly forth.

The walls rumble. Rocks fall.
You can't see the sky anymore!
There is no way out.

Dungeon Entrance
Stone walls, mildewed with glowing stuff, widen into a large cold room. 

A large, colorful sign is on the wall.

You can see a healing potion and a trophy case (closed) here.

Exits: east (Rockslide Cavern)

>exits
You can go west (Rockslide Cavern) from here.

Exits: west

>l
Dungeon Entrance
Stone walls, mildewed with glowing stuff, widen into a large bare room.

south (Disturbing Hallway)

>s
Exits are: north (Dungeon Entrance)
next room will be Disturbing Hallway
next direction will be down

Disturbing Hallway
north (Dungeon Entrance) or up (Disturbing Hallway) or down (Disturbing Hallway)

>exits
You can go north (Dungeon Entrance) or up (Disturbing Hallway) or down (Disturbing Hallway) from here.

north (Dungeon Entrance) or up (Disturbing Hallway) or down (Disturbing Hallway)

>d
Exits are: north (Dungeon Entrance) or up (Disturbing Hallway) or down (Disturbing Hallway)
next room will be Marble Halls
next direction will be north

Disturbing Hallway
north (Marble Halls) or up (Disturbing Hallway) or down (Disturbing Hallway)

>d
Exits are: north (Marble Halls) or up (Disturbing Hallway) or down (Disturbing Hallway)
next room will be Waterfall Pool
next direction will be east

Disturbing Hallway
north (Marble Halls) or east (Waterfall Pool) or up (Disturbing Hallway) or down (Disturbing Hallway)

>l
Disturbing Hallway
north (Marble Halls) or east (Waterfall Pool) or up (Disturbing Hallway) or down (Disturbing Hallway)

>exits
You can go north (Marble Halls) or east (Waterfall Pool) or up (Disturbing Hallway) or down (Disturbing Hallway) from here.

north (Marble Halls) or east (Waterfall Pool) or up (Disturbing Hallway) or down (Disturbing Hallway)

* * *

>exits
You can go west (Rockslide Cavern) from here.

Exits: west

>n
Lake of Tears
south or east

* * *

>exits
You can go west (Rockslide Cavern) from here.

Exits: west

>w
~~~~ next room will be Lake of Tears
~~~~ next direction will be down

Rockslide Cavern
You can see a giant bat here.

Exits: east or down

>exits
You can go east (Dungeon Entrance) or down (Lake of Tears) from here.

Exits: east or down

>d
~~~~ next room will be Lake of Tears
~~~~ next direction will be north

Lake of Tears
You can see a kobold here.

Exits: north or south or up

>exits
You can go north (Lake of Tears) or south (Lake of Tears) or up (Rockslide Cavern) from here.

Exits: north or south or up

>showme
Lake of Tears - room
    kobold - creature
    yourself - person

* * *

>d
You waddle valiantly forth.

The walls rumble. Rocks fall.
You can't see the sky anymore!
There is no way out.

Dungeon Entrance
Stone walls, mildewed with glowing stuff, widen into a large cold room. 

A large, colorful sign is on the wall.

You can see a healing potion and a trophy case (closed) here.

Exits: east (Rockslide Cavern)

>help
That's not a verb I recognise.

>peck rat
You viciously peck the giant rat, causing 3 points of damage!
You viciously peck the giant rat, causing 8 points of damage!

The giant rat falls over, gasping in pain.
"What ARE you?" it shrieks, scuttling away.
It drags itself off into the darkness.

Exits: west (Nasty Passage)

>l
Dungeon Entrance
Stone walls, mildewed with glowing stuff, widen into a large bare room.

You can see a diamond tiara, an AirDnD lanyard and a trophy case (empty) here.

Exits: west (Nasty Passage)

* * *

>d
You waddle valiantly forth.

The walls rumble. Rocks fall.
You can't see the sky anymore!
There is no way out.

Dungeon Entrance
Stone walls, mildewed with glowing stuff, widen into a large cold room. 

A large, colorful sign is on the wall.

You can see a healing potion and a trophy case (closed) here.

Exits: east (Rockslide Cavern)

>honk at kobold
I only understood you as far as wanting to honk.

* * *

>d
You waddle valiantly forth.

The walls rumble. Rocks fall.
You can't see the sky anymore!
There is no way out.

Dungeon Entrance
Stone walls, mildewed with glowing stuff, widen into a large cold room. 

A large, colorful sign is on the wall.

You can see a healing potion and a trophy case (closed) here.

Exits: east (Rockslide Cavern)

>honk at snake
I only understood you as far as wanting to honk.

* * *

>d
You waddle valiantly forth.

The walls rumble. Rocks fall.
You can't see the sky anymore!
There is no way out.

Dungeon Entrance
Stone walls, mildewed with glowing stuff, widen into a large cold room. 

A large, colorful sign is on the wall.

You can see a healing potion and a trophy case (closed) here.

Exits: east (Rockslide Cavern)

>i
You are carrying nothing.

Exits: east (Nasty Passage)

>e
Nasty Passage
A tight squeeze between damp and slimy boulders. There is blood on the ground.

You can see a wispy ghost here.

Exits: west (Dungeon Entrance) or down (Rockslide Cavern)

* * *

>d
You waddle valiantly forth.

The walls rumble. Rocks fall.
You can't see the sky anymore!
There is no way out.

Dungeon Entrance
Stone walls, mildewed with glowing stuff, widen into a large cold room. 

A large, colorful sign is on the wall.

You can see a healing potion and a trophy case (closed) here.

Exits: east (Rockslide Cavern)

>kill rat
You attack the giant rat, causing 4 points of damage!

The giant rat attacks you, causing 3 points of damage!

Exits: east (Glittering Shrine)

>kill rat
You attack the giant rat, causing 10 points of damage!

The giant rat falls over, gasping in pain. It drags itself off into the darkness.

Exits: east (Glittering Shrine)

>kill mummy
You attack the lumbering mummy, causing 3 points of damage!

The lumbering mummy attacks you, causing 3 points of damage!

Exits: east (Glittering Shrine)

>kill mummy
You attack the lumbering mummy, causing 7 points of damage!

The lumbering mummy attacks you, causing 4 points of damage!

Exits: east (Glittering Shrine)

>peck mummy
You jab your beak at the lumbering mummy.

Exits: east (Glittering Shrine)

* * *

>d
You waddle valiantly forth.

The walls rumble. Rocks fall.
You can't see the sky anymore!
There is no way out.

Dungeon Entrance
Stone walls, mildewed with glowing stuff, widen into a large cold room. 

A large, colorful sign is on the wall.

You can see a healing potion and a trophy case (closed) here.

Exits: east (Rockslide Cavern)

>l
Dungeon Entrance
Stone walls, mildewed with glowing stuff, widen into a large bare room.

>exits
You can go  from here.

* * *

>l
Dungeon Entrance
Stone walls, mildewed with glowing stuff, widen into a large bare room.

>n
Dungeon Entrance
Stone walls, mildewed with glowing stuff, widen into a large bare room.

>l
Dungeon Entrance
Stone walls, mildewed with glowing stuff, widen into a large bare room.

>w
Marble Halls

* * *

>d
You waddle valiantly forth.

The walls rumble. Rocks fall.
You can't see the sky anymore!
There is no way out.

Dungeon Entrance
Stone walls, mildewed with glowing stuff, widen into a large cold room. 

A large, colorful sign is on the wall.

You can see a healing potion and a trophy case (closed) here.

Exits: east (Rockslide Cavern)

>look sign
A glossy sign in bright orange and virulent green, with a stylized picture of a sword on a pile of money. It says, "Welcome to your new Dungeon Away From Home! Let AirDnD be your Guide, as we bring you to new depths in Adventuring! *AirDnD*

Exits: south (Luminous Gardens)

>read sign
A glossy sign in bright orange and virulent green, with a stylized picture of a sword on a pile of money. It says, "Welcome to your new Dungeon away from Home! Let AirDnD be your guide as we bring you to new depths in Adventuring!

Exits: south (Uncanny Lair)

* * *

>d
You waddle valiantly forth.

The walls rumble. Rocks fall.
You can't see the sky anymore!
There is no way out.

Dungeon Entrance
Stone walls, mildewed with glowing stuff, widen into a large cold room. 

A large, colorful sign is on the wall.

You can see a healing potion and a trophy case (closed) here.

Exits: east (Rockslide Cavern)

>n
Hissing a little, you peer from side to side.

removing south because you just came from there 

Hall of Time
A long, narrow hall, flickering with light from magefire sconces. The painted walls show the progression of time through planets and stars, sun and moons.

Exits: south (Dungeon Entrance) or down (Chamber of Lights)

>d
Unvisted: Jewelled Forest, Cavern of the Lake of Tears, Shorehaven, Evil Archives, Librarian's Lair, Glittering Shrine, Vault of Secrets, Webby Corridor, Chamber of Lights, Disturbing Hallway, Waterfall Cave, Marble Halls, Rockslide Cavern, Den of Darkness, Luminous Gardens, Nasty Passage, Chilly Mausoleum, Hall of Time and Vault of Vastness.
You are in Chamber of LightsYou are in Chamber of Lights for the FIRST time
Unpicked: Jewelled Forest, Evil Archives, Glittering Shrine, Webby Corridor, Disturbing Hallway, Waterfall Cave, Marble Halls, Rockslide Cavern, Den of Darkness, Luminous Gardens, Nasty Passage, Chilly Mausoleum and Hall of Time.
~~~~ next room will be Chilly Mausoleum
available directions: north, south, east, west and down
available directions: north, south, east, west and down
~~~~ next direction will be west

Chamber of Lights
An uncanny mottled glow emanates from the walls of this high-ceilinged cavern.

You can see a gelatinous cube here.

Exits: west (Chilly Mausoleum) or up (Uncanny Lair)

>n
Nasty Passage
You can see a kobold here.

Exits: south (Chamber of Lights) or down (Glittering Shrine)

>d
Glittering Shrine
You can see a tentacled horror here.

Exits: north (Den of Darkness) or up (Nasty Passage)

>n
Den of Darkness
You can see a glowering elf here.

Exits: north (Crumbling Corridor) or south (Glittering Shrine)

>n
Crumbling Corridor
You can see a wispy ghost here.

Exits: south (Den of Darkness) or down (Chilly Mausoleum)

>d
Chilly Mausoleum
Exits: east (Jewelled Forest) or up (Crumbling Corridor)

>e
Jewelled Forest
Exits: north (Waterfall Cave) or west (Chilly Mausoleum)

>n
Waterfall Cave
Water pours down from high above, catching on stalactites and glinting in the eerie glow from the walls. A little pool lies underneath.

Exits: south (Jewelled Forest) or west (Uncanny Lair)

>swim
You must supply a noun.

Exits: south (Jewelled Forest) or west (Uncanny Lair)

>swim in pool
I only understood you as far as wanting to swim.

* * *

>s
~~~~ next room will be Den of Darkness
Cardinal directions: north, south, east, west and down
removing north because you just came from there 
~~~~ next direction will be down

Uncanny Lair
You can see a spider here.

Exits: north or down

>d
~~~~ next room will be Marble Halls
Cardinal directions: north, south, east, west and down
~~~~ next direction will be north

Den of Darkness
You can see a giant bat here.

Exits: north or up

>n
~~~~ next room will be Waterfall Pool
Cardinal directions: north, south, east, west and down
removing south because you just came from there 
~~~~ next direction will be north

Marble Halls
Exits: north or south

>n
~~~~ next room will be Webby Corridor
Cardinal directions: north, south, east, west and down
removing south because you just came from there 
~~~~ next direction will be east

Waterfall Pool
Exits: south or east

>e
~~~~ next room will be Jewelled Forest
Cardinal directions: north, south, east, west and down
removing west because you just came from there 
~~~~ next direction will be south

Webby Corridor
You can see a gelatinous cube here.

Exits: south or west

>s
~~~~ next room will be Chamber of Lights
Cardinal directions: north, south, east, west and down
removing north because you just came from there 
~~~~ next direction will be east

Jewelled Forest
Exits: north or east

>e
~~~~ next room will be Disturbing Hallway
Cardinal directions: north, south, east, west and down
removing west because you just came from there 
~~~~ next direction will be south

Chamber of Lights
You can see a cave snake here.

Exits: south or west

>s
Exits: north

>l
Disturbing Hallway
Exits: north

* * *

>up
Unvisted: Jewelled Forest, Cavern of the Lake of Tears, Shorehaven, Evil Archives, Librarian's Lair, Glittering Shrine, Vault of Secrets, Webby Corridor, Disturbing Hallway, Waterfall Cave, Marble Halls, Rockslide Cavern, Den of Darkness, Luminous Gardens, Nasty Passage, Chilly Mausoleum, Hall of Time and Vault of Vastness.
You are in Uncanny LairYou are in Uncanny Lair for the FIRST time
Unpicked: Jewelled Forest, Evil Archives, Glittering Shrine, Webby Corridor, Disturbing Hallway, Waterfall Cave, Marble Halls, Rockslide Cavern, Den of Darkness, Luminous Gardens, Nasty Passage, Chilly Mausoleum and Hall of Time.
~~~~ next room will be Den of Darkness
available directions: north, south, east, west and down
removing south because you just came from there 
removing down because you just came from there 
available directions: north, east and west
~~~~ next direction will be west

Uncanny Lair
Oddly shaped bones are strewn about this rough cave. Some creature made a nest in one corner out of shredded fungus.

You can see a cave snake and a wispy ghost here.

Exits: south (Dungeon Entrance) or west (Den of Darkness) or down (Chamber of Lights)

>d
Unvisted: Jewelled Forest, Cavern of the Lake of Tears, Shorehaven, Evil Archives, Librarian's Lair, Glittering Shrine, Vault of Secrets, Webby Corridor, Disturbing Hallway, Waterfall Cave, Marble Halls, Rockslide Cavern, Den of Darkness, Luminous Gardens, Nasty Passage, Chilly Mausoleum, Hall of Time and Vault of Vastness.
You are in Chamber of LightsYou are in Chamber of Lights for the FIRST time
Unpicked: Jewelled Forest, Evil Archives, Glittering Shrine, Webby Corridor, Disturbing Hallway, Waterfall Cave, Marble Halls, Rockslide Cavern, Den of Darkness, Luminous Gardens, Nasty Passage, Chilly Mausoleum and Hall of Time.
~~~~ next room will be Rockslide Cavern
available directions: north, south, east, west and down
removing west because you just came from there 
available directions: north, south, east and down
~~~~ next direction will be east

Chamber of Lights
An uncanny mottled glow emanates from the walls of this high-ceilinged cavern.

You can see a gelatinous cube here.

Exits: east (Rockslide Cavern) or west (Chilly Mausoleum) or up (Uncanny Lair)

>up
Unvisted: Jewelled Forest, Cavern of the Lake of Tears, Shorehaven, Evil Archives, Librarian's Lair, Glittering Shrine, Vault of Secrets, Webby Corridor, Disturbing Hallway, Waterfall Cave, Marble Halls, Rockslide Cavern, Den of Darkness, Luminous Gardens, Nasty Passage, Chilly Mausoleum, Hall of Time and Vault of Vastness.
You are in Uncanny LairYou are in Uncanny Lair for the FIRST time
Unpicked: Jewelled Forest, Evil Archives, Glittering Shrine, Webby Corridor, Disturbing Hallway, Waterfall Cave, Marble Halls, Rockslide Cavern, Den of Darkness, Luminous Gardens, Nasty Passage, Chilly Mausoleum and Hall of Time.
~~~~ next room will be Webby Corridor
available directions: north, south, east, west and down
removing south because you just came from there 
removing west because you just came from there 
removing down because you just came from there 
available directions: north and east
~~~~ next direction will be east

Uncanny Lair
Oddly shaped bones are strewn about this rough cave. Some creature made a nest in one corner out of shredded fungus.

You can see a cave snake and a wispy ghost here.

Exits: south (Dungeon Entrance) or east (Webby Corridor) or west (Den of Darkness) or down (Chamber of Lights)

>w
Unvisted: Jewelled Forest, Cavern of the Lake of Tears, Shorehaven, Evil Archives, Librarian's Lair, Glittering Shrine, Vault of Secrets, Webby Corridor, Disturbing Hallway, Waterfall Cave, Marble Halls, Rockslide Cavern, Den of Darkness, Luminous Gardens, Nasty Passage, Chilly Mausoleum, Hall of Time and Vault of Vastness.
You are in Den of DarknessYou are in Den of Darkness for the FIRST time
Unpicked: Jewelled Forest, Evil Archives, Glittering Shrine, Webby Corridor, Disturbing Hallway, Waterfall Cave, Marble Halls, Rockslide Cavern, Luminous Gardens, Nasty Passage, Chilly Mausoleum and Hall of Time.
~~~~ next room will be Glittering Shrine
available directions: north, south, east, west and down
removing east because you just came from there 
available directions: north, south, west and down
~~~~ next direction will be down

Den of Darkness
The darkness softens, the room is hushed. It's hard to see your way out.

Exits: east (Uncanny Lair) or down (Glittering Shrine)

>e
Unvisted: Jewelled Forest, Cavern of the Lake of Tears, Shorehaven, Evil Archives, Librarian's Lair, Glittering Shrine, Vault of Secrets, Webby Corridor, Disturbing Hallway, Waterfall Cave, Marble Halls, Rockslide Cavern, Luminous Gardens, Nasty Passage, Chilly Mausoleum, Hall of Time and Vault of Vastness.
You are in Uncanny LairYou are in Uncanny Lair for the FIRST time
Unpicked: Jewelled Forest, Evil Archives, Glittering Shrine, Webby Corridor, Disturbing Hallway, Waterfall Cave, Marble Halls, Rockslide Cavern, Luminous Gardens, Nasty Passage, Chilly Mausoleum and Hall of Time.
~~~~ next room will be Hall of Time
available directions: north, south, east, west and down
removing south because you just came from there 
removing east because you just came from there 
removing west because you just came from there 
removing down because you just came from there 
available directions: north
~~~~ next direction will be north

Uncanny Lair
Oddly shaped bones are strewn about this rough cave. Some creature made a nest in one corner out of shredded fungus.

You can see a cave snake and a wispy ghost here.

Exits: north (Hall of Time) or south (Dungeon Entrance) or east (Webby Corridor) or west (Den of Darkness) or down (Chamber of Lights)

>s
Unvisted: Jewelled Forest, Cavern of the Lake of Tears, Shorehaven, Evil Archives, Librarian's Lair, Glittering Shrine, Vault of Secrets, Webby Corridor, Disturbing Hallway, Waterfall Cave, Marble Halls, Rockslide Cavern, Luminous Gardens, Nasty Passage, Chilly Mausoleum, Hall of Time and Vault of Vastness.
You are in Dungeon EntranceYou are in Dungeon Entrance for the FIRST time
Unpicked: Jewelled Forest, Evil Archives, Glittering Shrine, Webby Corridor, Disturbing Hallway, Waterfall Cave, Marble Halls, Rockslide Cavern, Luminous Gardens, Nasty Passage, Chilly Mausoleum and Hall of Time.
~~~~ next room will be Evil Archives
available directions: north, south, east, west and down
available directions: north, south, east, west and down
~~~~ next direction will be north

Dungeon Entrance
Stone walls, mildewed with glowing stuff, widen into a large bare room.

You can see a confused adventurer, a lumbering mummy, a giant rat and a trophy case (empty) here.

Exits: north (Evil Archives)

* * *

>w
Unpicked: Webby Corridor, Chamber of Lights, Disturbing Hallway, Waterfall Cave, Marble Halls, Jewelled Forest, Den of Darkness, Luminous Gardens, Nasty Passage, Vault of Vastness, Glittering Shrine, Chilly Mausoleum and Hall of Time.

Evil Archives
Row upon row of moldering tomes, dust, and a sense of forboding fill this underground library.

You can see a tentacled horror here.

Exits: east (Rockslide Cavern) or down (Hall of Time)

>d
Unpicked: Webby Corridor, Chamber of Lights, Disturbing Hallway, Waterfall Cave, Marble Halls, Jewelled Forest, Den of Darkness, Luminous Gardens, Nasty Passage, Vault of Vastness, Glittering Shrine and Chilly Mausoleum.

Hall of Time
A long, narrow hall, flickering with light from magefire sconces. The painted walls show the progression of time through planets and stars, sun and moons.

You can see a confused adventurer here.

Exits: up (Evil Archives) or down (Disturbing Hallway)

>d
Unpicked: Webby Corridor, Chamber of Lights, Waterfall Cave, Marble Halls, Jewelled Forest, Den of Darkness, Luminous Gardens, Nasty Passage, Vault of Vastness, Glittering Shrine and Chilly Mausoleum.

Disturbing Hallway
The angles here, the colors, the feel of the air -- just wrong. Horribly wrong.

You can see a lumbering mummy here.

Exits: up (Hall of Time) or down (Vault of Vastness)

>d
Unpicked: Webby Corridor, Chamber of Lights, Waterfall Cave, Marble Halls, Jewelled Forest, Den of Darkness, Luminous Gardens, Nasty Passage, Glittering Shrine and Chilly Mausoleum.

Vault of Vastness
Soaring arches overhead, stone display cases and cubbyholes in the walls. The treasure hall of a dragon, emptied of its loot.

You can see a wispy ghost here.

Exits: east (Den of Darkness) or up (Disturbing Hallway)

>e
Unpicked: Webby Corridor, Chamber of Lights, Waterfall Cave, Marble Halls, Jewelled Forest, Luminous Gardens, Nasty Passage, Glittering Shrine and Chilly Mausoleum.

Den of Darkness
The darkness softens, the room is hushed. It's hard to see your way out.

Exits: south (Nasty Passage) or west (Vault of Vastness)

>s
Unpicked: Webby Corridor, Chamber of Lights, Waterfall Cave, Marble Halls, Jewelled Forest, Luminous Gardens, Glittering Shrine and Chilly Mausoleum.

Nasty Passage
A tight squeeze between damp and slimy boulders. There is blood on the ground.

You can see a kobold here.

Exits: north (Den of Darkness) or down (Webby Corridor)

>d
Unpicked: Chamber of Lights, Waterfall Cave, Marble Halls, Jewelled Forest, Luminous Gardens, Glittering Shrine and Chilly Mausoleum.

Webby Corridor
Dusty ropes of thick spiderweb festoon the walls.

Exits: east (Jewelled Forest) or up (Nasty Passage)

>e
Unpicked: Chamber of Lights, Waterfall Cave, Marble Halls, Luminous Gardens, Glittering Shrine and Chilly Mausoleum.

Jewelled Forest
Marvellous columns march down the length of this immense cavern. Jewel-like lights shine from deep within.

You can see a soot sprite here.

Exits: east (Chamber of Lights) or west (Webby Corridor)

>e
Unpicked: Waterfall Cave, Marble Halls, Luminous Gardens, Glittering Shrine and Chilly Mausoleum.

Chamber of Lights
An uncanny mottled glow emanates from the walls of this high-ceilinged cavern.

You can see a cave snake here.

Exits: east (Waterfall Cave) or west (Jewelled Forest)

>e
Unpicked: Marble Halls, Luminous Gardens, Glittering Shrine and Chilly Mausoleum.

Waterfall Cave
Water pours down from high above, catching on stalactites and glinting in the eerie glow from the walls. A little pool lies underneath.

Exits: south (Chilly Mausoleum) or west (Chamber of Lights)

>s
Unpicked: Marble Halls, Luminous Gardens and Glittering Shrine.

Chilly Mausoleum
Cold seeps into your bones. Faceless tombs loom overhead.

Exits: north (Waterfall Cave) or south (Luminous Gardens)

>s
Unpicked: Marble Halls and Glittering Shrine.

Luminous Gardens
Mushrooms the size of trees, glowing, are scattered among winding paths. Tiny lightning bugs flit between snow-pale cave blossoms.

Exits: north (Chilly Mausoleum) or east (Glittering Shrine)

>e
Unpicked: Marble Halls.

Glittering Shrine
Flecks of shining mica gleam from granite walls.

You can see a gelatinous cube and an obsidian altar here.

Exits: west (Luminous Gardens) or down (Marble Halls)

>d
Unpicked: nothing.
You have reached a dead end.
Something stirs in the darkness.

Exits: up (Glittering Shrine)

* * *

>n
Hissing a little, you peer from side to side.

removing south because you just came from there 

Hall of Time
A long, narrow hall, flickering with light from magefire sconces. The painted walls show the progression of time through planets and stars, sun and moons.

Exits: south (Dungeon Entrance) or down (Chamber of Lights)

>l
Chamber of Lights

>exits
You can go  from here.

>actions
Actions listing on.

>l
[looking]
Chamber of Lights
[looking - succeeded]

>s
[going south]
You can't go that way.
[going south - failed the can't go that way rule]

>n
[going north]
You can't go that way.
[going north - failed the can't go that way rule]

>e
[going east]
You can't go that way.
[going east - failed the can't go that way rule]

>d
[going down]
You can't go that way.
[going down - failed the can't go that way rule]

>up
[going up]
You can't go that way.
[going up - failed the can't go that way rule]

* * *

>n
Hissing a little, you peer from side to side.

removing south because you just came from there 

Hall of Time
A long, narrow hall, flickering with light from magefire sconces. The painted walls show the progression of time through planets and stars, sun and moons.

Exits: south (Dungeon Entrance) or down (Chamber of Lights)

>n
Uncanny Lair
Oddly shaped bones are strewn about this rough cave. Some creature made a nest in one corner out of shredded fungus.

You can see a kobold here.

Exits: south (Marble Halls) or west (Vault of Vastness)

>peck kobold
You attack the kobold, causing 6 points of damage!
You attack the kobold, causing 7 points of damage!

The kobold falls over, gasping in pain. It drags itself off into the darkness.

Exits: south (Marble Halls) or west (Vault of Vastness)

>w
Vault of Vastness
Soaring arches overhead, stone display cases and cubbyholes in the walls. The treasure hall of a dragon, emptied of its loot.

Exits: east (Uncanny Lair) or west (Disturbing Hallway)

>w
Disturbing Hallway
The angles here, the colors, the feel of the air -- just wrong. Horribly wrong.

Exits: south (Jewelled Forest) or east (Vault of Vastness)

>s
Jewelled Forest
Marvellous columns march down the length of this immense cavern. Jewel-like lights shine from deep within.

Exits: north (Disturbing Hallway) or south (Den of Darkness) or west (Cavern of the Lake of Tears)

>s
Den of Darkness
The darkness softens, the room is hushed. It's hard to see your way out.

You can see a wispy ghost here.

Exits: north (Jewelled Forest) or south (Chamber of Lights)

>attack ghost
You attack the wispy ghost, causing 4 points of damage!
You attack the wispy ghost, causing 3 points of damage!
You attack the wispy ghost, causing 9 points of damage!

The wispy ghost falls over, gasping in pain. It drags itself off into the darkness.

Exits: north (Jewelled Forest) or south (Chamber of Lights)

>s
Chamber of Lights
An uncanny mottled glow emanates from the walls of this high-ceilinged cavern.

You can see a cave snake here.

Exits: north (Den of Darkness) or east (Rockslide Cavern)

>kill snake
You attack the cave snake, causing 5 points of damage!
You attack the cave snake, causing 4 points of damage!
You attack the cave snake, causing 5 points of damage!

The cave snake falls over, gasping in pain. It drags itself off into the darkness.

Exits: north (Den of Darkness) or east (Rockslide Cavern)

>e
Rockslide Cavern
Boulders have tumbled down on one side of this cave. It's a tight squeeze to get by them.

You can see a glowering elf here.

Exits: east (Chilly Mausoleum) or west (Chamber of Lights)

>kill elf
You attack the glowering elf, causing 10 points of damage!
You attack the glowering elf, causing 9 points of damage!
You attack the glowering elf, causing 4 points of damage!

The glowering elf falls over, gasping in pain. It drags itself off into the darkness.

Exits: east (Chilly Mausoleum) or west (Chamber of Lights)

>e
Chilly Mausoleum
Cold seeps into your bones. Faceless tombs loom overhead.

You can see a tentacled horror here.

Exits: east (Evil Archives) or west (Rockslide Cavern)

>kill horror
You attack the tentacled horror, causing 6 points of damage!
You attack the tentacled horror, causing 9 points of damage!
You attack the tentacled horror, causing 4 points of damage!

The tentacled horror attacks you, causing 4 points of damage!

Exits: east (Evil Archives) or west (Rockslide Cavern)

>kill horror
You attack the tentacled horror, causing 3 points of damage!
You attack the tentacled horror, causing 7 points of damage!

The tentacled horror falls over, gasping in pain. It drags itself off into the darkness.

Exits: east (Evil Archives) or west (Rockslide Cavern)

>e
Evil Archives
Row upon row of moldering tomes, dust, and a sense of forboding fill this underground library.

Exits: south (Luminous Gardens) or west (Chilly Mausoleum)

>s
Luminous Gardens
Mushrooms the size of trees, glowing, are scattered among winding paths. Tiny lightning bugs flit between snow-pale cave blossoms.

You can see a spider here.

Exits: north (Evil Archives) or south (Waterfall Cave)

>kill spider
You attack the spider, causing 9 points of damage!

The spider falls over, gasping in pain. It drags itself off into the darkness.

Exits: north (Evil Archives) or south (Waterfall Cave)

>s
Waterfall Cave
Water pours down from high above, catching on stalactites and glinting in the eerie glow from the walls. A little pool lies underneath.

You can see a lumbering mummy here.

Exits: north (Luminous Gardens) or down (Glittering Shrine)

>d
Glittering Shrine
Flecks of shining mica gleam from granite walls.

You can see an iridium bat and an obsidian altar here.

Exits: up (Waterfall Cave) or down (Webby Corridor)

>stand on altar
That's not something you can stand on.

Exits: up (Waterfall Cave) or down (Webby Corridor)

>d
Webby Corridor
Dusty ropes of thick spiderweb festoon the walls.

You can see a confused adventurer here.

Exits: up (Glittering Shrine) or down (Nasty Passage)

>kill adventurer
You attack the confused adventurer, causing 10 points of damage!
You attack the confused adventurer, causing 10 points of damage!

The confused adventurer falls over, gasping in pain. It drags itself off into the darkness.

Exits: up (Glittering Shrine) or down (Nasty Passage)

>d
Nasty Passage
A tight squeeze between damp and slimy boulders. There is blood on the ground.

You can see a soot sprite here.

Exits: up (Webby Corridor) or down (Hall of Time)

>d
You have reached a dead end.
Something stirs in the darkness.

Exits: up (Nasty Passage)

>l
Hall of Time
A long, narrow hall, flickering with light from magefire sconces. The painted walls show the progression of time through planets and stars, sun and moons.

You can see a sleeping dragon here.

Exits: up (Nasty Passage)

>kill dragon
You attack the sleeping dragon, causing 7 points of damage!
You attack the sleeping dragon, causing 5 points of damage!
You attack the sleeping dragon, causing 6 points of damage!

The sleeping dragon attacks you, causing 3 points of damage!

Exits: up (Nasty Passage)

>kill dragon
You attack the sleeping dragon, causing 9 points of damage!
You attack the sleeping dragon, causing 10 points of damage!
You attack the sleeping dragon, causing 6 points of damage!

The sleeping dragon falls over, gasping in pain. It drags itself off into the darkness.

Exits: up (Nasty Passage)

* * *

>n
Hissing a little, you peer from side to side.

removing south because you just came from there 

Hall of Time
A long, narrow hall, flickering with light from magefire sconces. The painted walls show the progression of time through planets and stars, sun and moons.

Exits: south (Dungeon Entrance) or down (Chamber of Lights)

>s
You waddle valiantly forth.

Dungeon Entrance
Stone walls, mildewed with glowing stuff, widen into a large cold room. A sign is on the wall.

You can see a lumbering mummy and a trophy case (empty) here.

Exits: north (Hall of Time)

>n
Unpicked: Webby Corridor, Chamber of Lights, Disturbing Hallway, Waterfall Cave, Marble Halls, Jewelled Forest, Uncanny Lair, Den of Darkness, Evil Archives, Luminous Gardens, Nasty Passage, Vault of Vastness, Glittering Shrine, Chilly Mausoleum and Hall of Time.

Rockslide Cavern
Boulders have tumbled down on one side of this cave. It's a tight squeeze to get by them.

You can see a lumbering mummy and a cave snake here.

Exits: north (Uncanny Lair) or south (Dungeon Entrance) or down (Glittering Shrine)

>n
Unpicked: Webby Corridor, Chamber of Lights, Disturbing Hallway, Waterfall Cave, Marble Halls, Jewelled Forest, Den of Darkness, Evil Archives, Luminous Gardens, Nasty Passage, Vault of Vastness, Glittering Shrine, Chilly Mausoleum and Hall of Time.

Uncanny Lair
Oddly shaped bones are strewn about this rough cave. Some creature made a nest in one corner out of shredded fungus.

You can see an iridium bat here.

Exits: south (Rockslide Cavern) or down (Den of Darkness)

>d
Unpicked: Webby Corridor, Chamber of Lights, Disturbing Hallway, Waterfall Cave, Marble Halls, Jewelled Forest, Evil Archives, Luminous Gardens, Nasty Passage, Vault of Vastness, Glittering Shrine, Chilly Mausoleum and Hall of Time.

Den of Darkness
The darkness softens, the room is hushed. It's hard to see your way out.

You can see a gelatinous cube here.

Exits: up (Uncanny Lair) or down (Luminous Gardens)

>d
Unpicked: Webby Corridor, Chamber of Lights, Disturbing Hallway, Waterfall Cave, Marble Halls, Jewelled Forest, Evil Archives, Nasty Passage, Vault of Vastness, Glittering Shrine, Chilly Mausoleum and Hall of Time.

Luminous Gardens
Mushrooms the size of trees, glowing, are scattered among winding paths. Tiny lightning bugs flit between snow-pale cave blossoms.

Exits: west (Vault of Vastness) or up (Den of Darkness)

>w
Unpicked: Webby Corridor, Chamber of Lights, Disturbing Hallway, Waterfall Cave, Marble Halls, Jewelled Forest, Evil Archives, Nasty Passage, Glittering Shrine, Chilly Mausoleum and Hall of Time.

Vault of Vastness
Soaring arches overhead, stone display cases and cubbyholes in the walls. The treasure hall of a dragon, emptied of its loot.

You can see a spider here.

Exits: east (Luminous Gardens) or west (Webby Corridor)

>w
Unpicked: Chamber of Lights, Disturbing Hallway, Waterfall Cave, Marble Halls, Jewelled Forest, Evil Archives, Nasty Passage, Glittering Shrine, Chilly Mausoleum and Hall of Time.

Webby Corridor
Dusty ropes of thick spiderweb festoon the walls.

Exits: east (Vault of Vastness) or down (Evil Archives)

>d
Unpicked: Chamber of Lights, Disturbing Hallway, Waterfall Cave, Marble Halls, Jewelled Forest, Nasty Passage, Glittering Shrine, Chilly Mausoleum and Hall of Time.

Evil Archives
Row upon row of moldering tomes, dust, and a sense of forboding fill this underground library.

You can see a kobold here.

Exits: south (Glittering Shrine) or up (Webby Corridor)

>s
Unpicked: Chamber of Lights, Disturbing Hallway, Waterfall Cave, Marble Halls, Jewelled Forest, Nasty Passage, Chilly Mausoleum and Hall of Time.

Glittering Shrine
Flecks of shining mica gleam from granite walls.

You can see a glowering elf and an obsidian altar here.

Exits: north (Evil Archives) or east (Jewelled Forest) or up (Rockslide Cavern)

>e
Unpicked: Chamber of Lights, Disturbing Hallway, Waterfall Cave, Marble Halls, Nasty Passage, Chilly Mausoleum and Hall of Time.

Jewelled Forest
Marvellous columns march down the length of this immense cavern. Jewel-like lights shine from deep within.

Exits: west (Glittering Shrine) or down (Hall of Time)

>d
Unpicked: Chamber of Lights, Disturbing Hallway, Waterfall Cave, Marble Halls, Nasty Passage and Chilly Mausoleum.

Hall of Time
A long, narrow hall, flickering with light from magefire sconces. The painted walls show the progression of time through planets and stars, sun and moons.

Exits: east (Nasty Passage) or up (Jewelled Forest)

>e
Unpicked: Chamber of Lights, Disturbing Hallway, Waterfall Cave, Marble Halls and Chilly Mausoleum.

Nasty Passage
A tight squeeze between damp and slimy boulders. There is blood on the ground.

You can see a tentacled horror here.

Exits: south (Chilly Mausoleum) or west (Hall of Time)

>s
Unpicked: Chamber of Lights, Disturbing Hallway, Waterfall Cave and Marble Halls.

Chilly Mausoleum
Cold seeps into your bones. Faceless tombs loom overhead.

Exits: north (Nasty Passage) or west (Waterfall Cave)

>w
Unpicked: Chamber of Lights, Disturbing Hallway and Marble Halls.

Waterfall Cave
Water pours down from high above, catching on stalactites and glinting in the eerie glow from the walls. A little pool lies underneath.

You can see a confused adventurer here.

Exits: south (Marble Halls) or east (Chilly Mausoleum)

>s
Unpicked: Chamber of Lights and Disturbing Hallway.

Marble Halls
White flowstone gleams in thick curtains on the walls of this magnificent hall.

Exits: north (Waterfall Cave) or south (Disturbing Hallway)

>s
Unpicked: Chamber of Lights.

Disturbing Hallway
The angles here, the colors, the feel of the air -- just wrong. Horribly wrong.

Exits: north (Marble Halls) or down (Chamber of Lights)

>d
Unpicked: nothing.
You have reached a dead end.
Something stirs in the darkness.

Exits: up (Disturbing Hallway)

>l
Chamber of Lights
An uncanny mottled glow emanates from the walls of this high-ceilinged cavern.

You can see a sleeping dragon here.

Exits: up (Disturbing Hallway)

>up
Unpicked: nothing.

Exits: north (Marble Halls) or down (Chamber of Lights)

>n
Unpicked: nothing.

Exits: north (Waterfall Cave) or south (Disturbing Hallway)

>n
Unpicked: nothing.

Exits: south (Marble Halls) or east (Chilly Mausoleum)

>e
Unpicked: nothing.

Exits: north (Nasty Passage) or west (Waterfall Cave)

>n
Unpicked: nothing.

Exits: south (Chilly Mausoleum) or west (Hall of Time)

>w
Unpicked: nothing.

Exits: east (Nasty Passage) or up (Jewelled Forest)

>up
Unpicked: nothing.

Exits: west (Glittering Shrine) or down (Hall of Time)

>w
Unpicked: nothing.

Exits: north (Evil Archives) or east (Jewelled Forest) or up (Rockslide Cavern)

>l
Glittering Shrine
Flecks of shining mica gleam from granite walls.

You can see a glowering elf and an obsidian altar here.

Exits: north (Evil Archives) or east (Jewelled Forest) or up (Rockslide Cavern)

* * *

>s
You waddle valiantly forth.

Dungeon Entrance
Stone walls, mildewed with glowing stuff, widen into a large cold room. A sign is on the wall.

You can see a lumbering mummy and a trophy case (empty) here.

Exits: north (Hall of Time)

>peck mummy
You viciously peck the lumbering mummy, causing 8 points of damage!
You viciously peck the lumbering mummy, causing 10 points of damage!

The lumbering mummy trips and falls.
"That's it, I quit!" it shrieks.
The lumbering mummy drags itself off into the darkness.

Exits: north (Hall of Time)

[Your score has just gone up by one point.]

>n
Your beady-eyed glance darts across yet another corridor.

Hall of Time
A long, narrow hall, flickering with light from magefire sconces. The painted walls show the progression of time through planets and stars, sun and moons.

Exits: south (Dungeon Entrance) or down (Chamber of Lights)

>d
Your beady-eyed glance darts across yet another corridor.

Chamber of Lights
An uncanny mottled glow emanates from the walls of this high-ceilinged cavern. An orange and green motto, made of eerie light, floats in the air.

You can see an AirDnD lanyard and a healing potion here.

Exits: south (Disturbing Hallway) or up (Hall of Time)

>take all
AirDnD lanyard: Taken.
healing potion: Taken.

Exits: south (Disturbing Hallway) or up (Hall of Time)

>s
You waddle valiantly forth.

removing north because you just came from there 

Disturbing Hallway
The angles here, the colors, the feel of the air -- just wrong. Horribly wrong.

Exits: north (Chamber of Lights) or south (Nasty Passage)

>s
Grunting with effort, you clamber over the rocky floor.

removing north because you just came from there 

Nasty Passage
A tight squeeze between damp and slimy boulders. There is blood on the ground.

Exits: north (Disturbing Hallway) or down (Jewelled Forest)

>d
Attempting stealth, you stretch out your long and graceful neck.

Jewelled Forest
Marvellous columns march down the length of this immense cave. Jewel-like lights shine from deep within.

You can see an AirDnD headlamp here.

Exits: west (Chilly Mausoleum) or up (Nasty Passage)

>take all
AirDnD headlamp: Taken.

Exits: west (Chilly Mausoleum) or up (Nasty Passage)

>wear headlamp
Exits: west (Chilly Mausoleum) or up (Nasty Passage)

>i
You are carrying: 
  an AirDnD headlamp (worn on head)
  a healing potion
  an AirDnD lanyard

Exits: west (Chilly Mausoleum) or up (Nasty Passage)

* * *

>n
Hissing a little, you peer from side to side.

removing south because you just came from there 

Hall of Time
A long, narrow hall, flickering with light from magefire sconces. The painted walls show the progression of time through planets and stars, sun and moons.

Exits: south (Dungeon Entrance) or down (Chamber of Lights)

>w
Unpicked: Webby Corridor, Chamber of Lights, Waterfall Cave, Marble Halls, Jewelled Forest, Rockslide Cavern, Uncanny Lair, Den of Darkness, Evil Archives, Nasty Passage, Vault of Vastness, Glittering Shrine, Chilly Mausoleum and Hall of Time.

Luminous Gardens
Mushrooms the size of trees, glowing, are scattered among winding paths. Tiny lightning bugs flit between snow-pale cave blossoms.

You can see an iridium bat here.

Exits: east (Disturbing Hallway) or west (Nasty Passage)

>d
~~~~ next room will be Lake of Tears
Cardinal directions: north, south, east, west and down
Available directions: north, south, east, west and down
~~~~ next direction will be down

Jewelled Forest
Exits: up or down

>d
~~~~ next room will be Waterfall Pool
Cardinal directions: north, south, east, west and down
Available directions: north, south, east, west and down
~~~~ next direction will be east

Lake of Tears
Exits: east or up

>e
~~~~ next room will be Marble Halls
Cardinal directions: north, south, east, west and down
Available directions: north, south, east and down
~~~~ next direction will be west

Waterfall Pool
Exits: west

>w
~~~~ next room will be Chamber of Lights
Cardinal directions: north, south, east, west and down
Available directions: north, south, west and down
~~~~ next direction will be down

Marble Halls
You can see a kobold here.

Exits: east or down

>d
~~~~ next room will be Den of Darkness
Cardinal directions: north, south, east, west and down
Available directions: north, south, east, west and down
~~~~ next direction will be down

Chamber of Lights
You can see a gelatinous cube here.

Exits: up or down

>d
~~~~ next room will be Uncanny Lair
Cardinal directions: north, south, east, west and down
Available directions: north, south, east, west and down
~~~~ next direction will be east

Den of Darkness
You can see a cave snake here.

Exits: east or up

>e
~~~~ next room will be Webby Corridor
Cardinal directions: north, south, east, west and down
Available directions: north, south, east and down
~~~~ next direction will be down

*** Run-time problem P26: Attempt to choose a random row in an entirely blank table: table 'Table of Mobs'.

Uncanny Lair
Exits: west or down

* * *

>w
Unpicked: Webby Corridor, Chamber of Lights, Waterfall Cave, Marble Halls, Jewelled Forest, Rockslide Cavern, Uncanny Lair, Den of Darkness, Evil Archives, Nasty Passage, Vault of Vastness, Glittering Shrine, Chilly Mausoleum and Hall of Time.

Luminous Gardens
Mushrooms the size of trees, glowing, are scattered among winding paths. Tiny lightning bugs flit between snow-pale cave blossoms.

You can see an iridium bat here.

Exits: east (Disturbing Hallway) or west (Nasty Passage)

>n
Luminous Gardens
Exits: south (Glittering Shrine) or west (Uncanny Lair)

>w
Uncanny Lair
Exits: east (Luminous Gardens) or west (Waterfall Pool)

>w
Waterfall Pool
Water pours down from high above, catching on stalactites and glinting in the eerie glow from the walls. A little pool lies underneath.

You can see a tentacled horror here.

Exits: south (Jewelled Forest) or east (Uncanny Lair)

>swim in pool
I didn't understand that sentence.

>swim
I didn't understand that sentence.

* * *

>w
Unpicked: Webby Corridor, Chamber of Lights, Waterfall Cave, Marble Halls, Jewelled Forest, Rockslide Cavern, Uncanny Lair, Den of Darkness, Evil Archives, Nasty Passage, Vault of Vastness, Glittering Shrine, Chilly Mausoleum and Hall of Time.

Luminous Gardens
Mushrooms the size of trees, glowing, are scattered among winding paths. Tiny lightning bugs flit between snow-pale cave blossoms.

You can see an iridium bat here.

Exits: east (Disturbing Hallway) or west (Nasty Passage)

>s
Den of Darkness
You can see a soot sprite here.

Exits: north (Disturbing Hallway) or south (Luminous Gardens)

>d
Chilly Mausoleum
Exits: south (Nasty Passage) or up (Disturbing Hallway)

>s
You have reached a dead end.
Something stirs in the darkness.

Exits: north (Chilly Mausoleum)

* * *

>s
Den of Darkness
You can see a soot sprite here.

Exits: north (Disturbing Hallway) or south (Luminous Gardens)

>s
Luminous Gardens
Exits: north (Den of Darkness) or east (Vault of Vastness)

>e
Vault of Vastness
Exits: east (Hall of Time) or west (Luminous Gardens)

>e
Hall of Time
You can see a kobold here.

Exits: west (Vault of Vastness) or down (Glittering Shrine)

>d
Glittering Shrine
You can see a cave snake here.

Exits: up (Hall of Time) or down (Waterfall Pool)

>d
Waterfall Pool
Water pours down from high above, catching on stalactites and glinting in the eerie glow from the walls. A little pool lies underneath.

Exits: up (Glittering Shrine) or down (Evil Archives)

>swim in pool
I didn't understand that sentence.

* * *

>w
Unpicked: Webby Corridor, Chamber of Lights, Waterfall Cave, Marble Halls, Jewelled Forest, Rockslide Cavern, Uncanny Lair, Den of Darkness, Evil Archives, Nasty Passage, Vault of Vastness, Glittering Shrine, Chilly Mausoleum and Hall of Time.

Luminous Gardens
Mushrooms the size of trees, glowing, are scattered among winding paths. Tiny lightning bugs flit between snow-pale cave blossoms.

You can see an iridium bat here.

Exits: east (Disturbing Hallway) or west (Nasty Passage)

>w
Unpicked: Webby Corridor, Chamber of Lights, Waterfall Cave, Marble Halls, Jewelled Forest, Rockslide Cavern, Uncanny Lair, Den of Darkness, Evil Archives, Vault of Vastness, Glittering Shrine, Chilly Mausoleum and Hall of Time.

Nasty Passage
A tight squeeze between damp and slimy boulders. There is blood on the ground.

You can see a gelatinous cube here.

Exits: east (Luminous Gardens) or down (Rockslide Cavern)

>d
Unpicked: Webby Corridor, Chamber of Lights, Waterfall Cave, Marble Halls, Jewelled Forest, Uncanny Lair, Den of Darkness, Evil Archives, Vault of Vastness, Glittering Shrine, Chilly Mausoleum and Hall of Time.

Rockslide Cavern
Boulders have tumbled down on one side of this cave. It's a tight squeeze to get by them.

You can see a soot sprite here.

Exits: south (Den of Darkness) or up (Nasty Passage)

>s
Unpicked: Webby Corridor, Chamber of Lights, Waterfall Cave, Marble Halls, Jewelled Forest, Uncanny Lair, Evil Archives, Vault of Vastness, Glittering Shrine, Chilly Mausoleum and Hall of Time.

Den of Darkness
The darkness softens, the room is hushed. It's hard to see your way out.

You can see a confused adventurer here.

Exits: north (Rockslide Cavern) or south (Chamber of Lights)

>s
Unpicked: Webby Corridor, Waterfall Cave, Marble Halls, Jewelled Forest, Uncanny Lair, Evil Archives, Vault of Vastness, Glittering Shrine, Chilly Mausoleum and Hall of Time.

Chamber of Lights
An uncanny mottled glow emanates from the walls of this high-ceilinged cavern.

Exits: north (Den of Darkness) or south (Glittering Shrine)

>s
Unpicked: Webby Corridor, Waterfall Cave, Marble Halls, Jewelled Forest, Uncanny Lair, Evil Archives, Vault of Vastness, Chilly Mausoleum and Hall of Time.

Glittering Shrine
Flecks of shining mica gleam from granite walls.

You can see an obsidian altar here.

Exits: north (Chamber of Lights) or west (Marble Halls)

>w
Unpicked: Webby Corridor, Waterfall Cave, Jewelled Forest, Uncanny Lair, Evil Archives, Vault of Vastness, Chilly Mausoleum and Hall of Time.

Marble Halls
White flowstone gleams in thick curtains on the walls of this magnificent hall.

Exits: east (Glittering Shrine) or west (Uncanny Lair)

>w
Unpicked: Webby Corridor, Waterfall Cave, Jewelled Forest, Evil Archives, Vault of Vastness, Chilly Mausoleum and Hall of Time.

Uncanny Lair
Oddly shaped bones are strewn about this rough cave. Some creature made a nest in one corner out of shredded fungus.

Exits: east (Marble Halls) or west (Jewelled Forest)

>w
Unpicked: Webby Corridor, Waterfall Cave, Evil Archives, Vault of Vastness, Chilly Mausoleum and Hall of Time.

Jewelled Forest
Marvellous columns march down the length of this immense cavern. Jewel-like lights shine from deep within.

Exits: south (Hall of Time) or east (Uncanny Lair) or west (Cavern of the Lake of Tears)

>s
Unpicked: Webby Corridor, Waterfall Cave, Evil Archives, Vault of Vastness and Chilly Mausoleum.

Hall of Time
A long, narrow hall, flickering with light from magefire sconces. The painted walls show the progression of time through planets and stars, sun and moons.

Exits: north (Jewelled Forest) or down (Vault of Vastness)

>d
Unpicked: Webby Corridor, Waterfall Cave, Evil Archives and Chilly Mausoleum.

Vault of Vastness
Soaring arches overhead, stone display cases and cubbyholes in the walls. The treasure hall of a dragon, emptied of its loot.

You can see a cave snake here.

Exits: east (Waterfall Cave) or up (Hall of Time)

>e
Unpicked: Webby Corridor, Evil Archives and Chilly Mausoleum.

Waterfall Cave
Water pours down from high above, catching on stalactites and glinting in the eerie glow from the walls. A little pool lies underneath.

You can see a spider here.

Exits: south (Chilly Mausoleum) or west (Vault of Vastness)

>s
Unpicked: Webby Corridor and Evil Archives.

Chilly Mausoleum
Cold seeps into your bones. Faceless tombs loom overhead.

You can see a lumbering mummy here.

Exits: north (Waterfall Cave) or south (Evil Archives)

>s
Unpicked: Webby Corridor.

Evil Archives
Row upon row of moldering tomes, dust, and a sense of forboding fill this underground library.

You can see a glowering elf here.

Exits: north (Chilly Mausoleum) or east (Webby Corridor)

>e
Unpicked: nothing.
You have reached a dead end.
Something stirs in the darkness.

Exits: west (Evil Archives)

>w
Unpicked: nothing.
You have reached a dead end.
Something stirs in the darkness.

Exits: north (Chilly Mausoleum) or east (Webby Corridor)

* * *

>w
Unpicked: Webby Corridor, Chamber of Lights, Waterfall Cave, Marble Halls, Jewelled Forest, Rockslide Cavern, Uncanny Lair, Den of Darkness, Evil Archives, Vault of Vastness, Glittering Shrine, Chilly Mausoleum and Hall of Time.

Nasty Passage
A tight squeeze between damp and slimy boulders. There is blood on the ground.

You can see a gelatinous cube here.

Exits: east (Luminous Gardens) or down (Rockslide Cavern)

>e
Cavern of the Lake of Tears
A still, deep lake stretches into the distance. It's vast. You can't see the other side.

Exits: south (Disturbing Hallway) or east (Jewelled Forest) or west (Shorehaven) or down (Vault of Vastness)

>swim
You must supply a noun.

Exits: south (Disturbing Hallway) or east (Jewelled Forest) or west (Shorehaven) or down (Vault of Vastness)

>swim in lake
I only understood you as far as wanting to swim.

>swim lake
I only understood you as far as wanting to swim.

* * *

>d
You waddle valiantly forth.

The walls rumble. Rocks fall.
You can't see the sky anymore!
There is no way out.

Dungeon Entrance
Stone walls, mildewed with glowing stuff, widen into a large cold room. 

A large, colorful sign is on the wall.

You can see a healing potion and a trophy case (closed) here.

Exits: east (Rockslide Cavern)

>ne
Marble Halls

* * *

>d
You waddle valiantly forth.

The walls rumble. Rocks fall.
You can't see the sky anymore!
There is no way out.

Dungeon Entrance
Stone walls, mildewed with glowing stuff, widen into a large cold room. 

A large, colorful sign is on the wall.

You can see a healing potion and a trophy case (closed) here.

Exits: east (Rockslide Cavern)

>nw
You can't go that way.

>w
You can't go that way.

>e
You can't go that way.

>exits
You can go up (Magnificent ruins) from here.

* * *

>d
You waddle valiantly forth.

The walls rumble. Rocks fall.
You can't see the sky anymore!
There is no way out.

Dungeon Entrance
Stone walls, mildewed with glowing stuff, widen into a large cold room. 

A large, colorful sign is on the wall.

You can see a healing potion and a trophy case (closed) here.

Exits: east (Rockslide Cavern)

>open case
You open the trophy case, revealing a discarded pay stub.

Exits: north (Disturbing Hallway)

>take stub
Taken.

Exits: north (Disturbing Hallway)

>read stub
A dirty piece of parchment. It reads:

At AirDnD, the only limit to your career is how much you care! We love being Your Dungeon Away From Home.
Title: Associate Rogue
Associate ID: 6669982100BX
Name: Kstlyplk Squishface
Days: 7, Hours: 89
 Pay rate: 2 copper coins per day
 Vacation: 0 hours 
Accidental Enchantment, Dismemberment, and Death Insurance: -1 copper coin per week
Armor cleaning fee: 3 half coppers
Workplace safety training fee: 1 groat
Weapon, fang, and claw sharpening fee: 1 half groat 
Total pay: 5.5 copper

Exits: down (Luminous Gardens)

* * *

>take stub
Taken.

Exits: north (Disturbing Hallway)

>x stub
A dirty piece of parchment. It reads:

At AirDnD, the only limit to your career is how much you care! 
We love being Your Dungeon Away From Home.

Title: Associate Rogue
Associate ID: 6669982100BX
Name: Kstlyplk Squishface
Days: 7, Hours: 89
 Pay rate: 2 copper coins per day
 Vacation: 0 hours 
Accidental Enchantment, Dismemberment, and Death Insurance: -1 copper coin per week
Armor cleaning fee: 3 half coppers
Workplace safety training fee: 1 groat
Weapon, fang, and claw sharpening fee: 1 half groat 
Total pay: 5.5 copper

Exits: north (Disturbing Hallway)

* * *

>d
You waddle valiantly forth.

The walls rumble. Rocks fall.
You can't see the sky anymore!
There is no way out.

Dungeon Entrance
Stone walls, mildewed with glowing stuff, widen into a large cold room. 

A large, colorful sign is on the wall.

You can see a healing potion and a trophy case (closed) here.

Exits: east (Rockslide Cavern)

>out
Disturbing Hallway

>exits
You can go inside (Dungeon Entrance) from here.

* * *

>d
You waddle valiantly forth.

The walls rumble. Rocks fall.
You can't see the sky anymore!
There is no way out.

Dungeon Entrance
Stone walls, mildewed with glowing stuff, widen into a large cold room. 

A large, colorful sign is on the wall.

You can see a healing potion and a trophy case (closed) here.

Exits: east (Rockslide Cavern)

>peck elf
You attack the glowering elf, causing 5 points of damage!
You attack the glowering elf, causing 5 points of damage!

The glowering elf attacks you, causing 3 points of damage!
The glowering elf attacks you, causing 4 points of damage!

Exits: east (Nasty Passage)

>peck elf
You attack the glowering elf, causing 5 points of damage!
You attack the glowering elf, causing 10 points of damage!

The glowering elf attacks you, causing 3 points of damage!
The glowering elf attacks you, causing 5 points of damage!

You swoon.
The world shimmers and whirls.
You wake up nestled into a hollow of warm sand.
You feel completely healed after your nap.

Shorehaven
A peaceful, secluded little beach, just the right size for a dungeon-going goose. A good place to tuck your head under your wing for a short nap.

Exits: east (Cavern of the Lake of Tears)

>e
Cavern of the Lake of Tears
A still, deep lake stretches into the distance. It's vast. You can't see the other side.

You can see an iridium bat here.

Exits: east (Jewelled Forest) or west (Waterfall Cave)

>peck bat
You attack the iridium bat, causing 4 points of damage!
You attack the iridium bat, causing 8 points of damage!

The iridium bat attacks you, causing 4 points of damage!

Exits: east (Jewelled Forest) or west (Waterfall Cave)

>peck bat
You attack the iridium bat, causing 10 points of damage!

The iridium bat falls over, gasping in pain.
What ARE you?
It drags itself off into the darkness.

Exits: east (Jewelled Forest) or west (Waterfall Cave)

* * *

>d
You waddle valiantly forth.

The walls rumble. Rocks fall.
You can't see the sky anymore!
There is no way out.

Dungeon Entrance
Stone walls, mildewed with glowing stuff, widen into a large cold room. 

A large, colorful sign is on the wall.

You can see a healing potion and a trophy case (closed) here.

Exits: east (Rockslide Cavern)

>peck ghost
You viciously peck the wispy ghost, causing 8 points of damage!
You viciously peck the wispy ghost, causing 10 points of damage!

The wispy ghost falls over, gasping in pain.
"Ow, that's going too far!" it mutters.
The wispy ghost drags itself off into the darkness.

Exits: south (Jewelled Forest)

>peck rat
You viciously peck the giant rat, causing 3 points of damage!
You viciously peck the giant rat, causing 8 points of damage!

The giant rat falls over, gasping in pain.
"I went to Monster Polytechnic for this?" it whines, cringing.
The giant rat drags itself off into the darkness.

Exits: south (Jewelled Forest)

>s
Unvisted: Jewelled Forest, Cavern of the Lake of Tears, Shorehaven, Evil Archives, Librarian's Lair, Glittering Shrine, Vault of Secrets, Webby Corridor, Chamber of Lights, Disturbing Hallway, Waterfall Cave, Marble Halls, Rockslide Cavern, Uncanny Lair, Den of Darkness, Luminous Gardens, Nasty Passage, Chilly Mausoleum, Hall of Time and Vault of Vastness
.
You are in Jewelled Forest
The number of viable directions is 2.

Jewelled Forest
Marvellous columns march down the length of this immense cave. Jewel-like lights shine from deep within.

Exits: north (Dungeon Entrance) or west (Cavern of the Lake of Tears)

>n
You're going to a VISITED room.

Unvisted: Cavern of the Lake of Tears, Shorehaven, Evil Archives, Librarian's Lair, Glittering Shrine, Vault of Secrets, Webby Corridor, Chamber of Lights, Disturbing Hallway, Waterfall Cave, Marble Halls, Rockslide Cavern, Uncanny Lair, Den of Darkness, Luminous Gardens, Nasty Passage, Chilly Mausoleum, Hall of Time and Vault of Vastness
.
You are in Dungeon Entrance
The number of viable directions is 1.

Dungeon Entrance
Stone walls, mildewed with glowing stuff, widen into a large bare room.

You can see a trophy case (empty) here.

Exits: south (Jewelled Forest)

>s
You're going to a VISITED room.

Unvisted: Cavern of the Lake of Tears, Shorehaven, Evil Archives, Librarian's Lair, Glittering Shrine, Vault of Secrets, Webby Corridor, Chamber of Lights, Disturbing Hallway, Waterfall Cave, Marble Halls, Rockslide Cavern, Uncanny Lair, Den of Darkness, Luminous Gardens, Nasty Passage, Chilly Mausoleum, Hall of Time and Vault of Vastness
.
You are in Jewelled Forest
The number of viable directions is 2.

Jewelled Forest
Marvellous columns march down the length of this immense cave. Jewel-like lights shine from deep within.

Exits: north (Dungeon Entrance) or west (Cavern of the Lake of Tears)

>w
Unvisted: Cavern of the Lake of Tears, Shorehaven, Evil Archives, Librarian's Lair, Glittering Shrine, Vault of Secrets, Webby Corridor, Chamber of Lights, Disturbing Hallway, Waterfall Cave, Marble Halls, Rockslide Cavern, Uncanny Lair, Den of Darkness, Luminous Gardens, Nasty Passage, Chilly Mausoleum, Hall of Time and Vault of Vastness
.
You are in Cavern of the Lake of Tears
The number of viable directions is 1.
You are in Cavern of the Lake of Tears for the FIRST time
Unpicked: Jewelled Forest, Evil Archives, Glittering Shrine, Webby Corridor, Chamber of Lights, Disturbing Hallway, Waterfall Cave, Marble Halls, Rockslide Cavern, Uncanny Lair, Den of Darkness, Luminous Gardens, Nasty Passage, Chilly Mausoleum and Hall of Time.
~~~~ next room will be Rockslide Cavern
available directions: north, south, east, west and down
removing east because you just came from there 
available directions: north, south, west and down
~~~~ next direction will be down

Cavern of the Lake of Tears
A still, deep lake stretches into the distance. It's vast. You can't see the other side.

You can see a confused adventurer here.

Exits: east (Jewelled Forest) or down (Rockslide Cavern)

>d
Unvisted: Shorehaven, Evil Archives, Librarian's Lair, Glittering Shrine, Vault of Secrets, Webby Corridor, Chamber of Lights, Disturbing Hallway, Waterfall Cave, Marble Halls, Rockslide Cavern, Uncanny Lair, Den of Darkness, Luminous Gardens, Nasty Passage, Chilly Mausoleum, Hall of Time and Vault of Vastness
.
You are in Rockslide Cavern
The number of viable directions is 1.
You are in Rockslide Cavern for the FIRST time
Unpicked: Jewelled Forest, Evil Archives, Glittering Shrine, Webby Corridor, Chamber of Lights, Disturbing Hallway, Waterfall Cave, Marble Halls, Uncanny Lair, Den of Darkness, Luminous Gardens, Nasty Passage, Chilly Mausoleum and Hall of Time.
~~~~ next room will be Disturbing Hallway
available directions: north, south, east, west and down
available directions: north, south, east, west and down
~~~~ next direction will be east

Rockslide Cavern
Boulders have tumbled down on one side of this cave. It's a tight squeeze to get by them.

You can see a lumbering mummy here.

Exits: east (Disturbing Hallway) or up (Cavern of the Lake of Tears)

>e
Unvisted: Shorehaven, Evil Archives, Librarian's Lair, Glittering Shrine, Vault of Secrets, Webby Corridor, Chamber of Lights, Disturbing Hallway, Waterfall Cave, Marble Halls, Uncanny Lair, Den of Darkness, Luminous Gardens, Nasty Passage, Chilly Mausoleum, Hall of Time and Vault of Vastness
.
You are in Disturbing Hallway
The number of viable directions is 1.
You are in Disturbing Hallway for the FIRST time
Unpicked: Jewelled Forest, Evil Archives, Glittering Shrine, Webby Corridor, Chamber of Lights, Waterfall Cave, Marble Halls, Uncanny Lair, Den of Darkness, Luminous Gardens, Nasty Passage, Chilly Mausoleum and Hall of Time.
~~~~ next room will be Evil Archives
available directions: north, south, east, west and down
removing west because you just came from there 
available directions: north, south, east and down
~~~~ next direction will be down

Disturbing Hallway
The angles here, the colors, the feel of the air -- just wrong. Horribly wrong.

You can see a tentacled horror here.

Exits: west (Rockslide Cavern) or down (Evil Archives)

>w
You're going to a VISITED room.

Unvisted: Shorehaven, Evil Archives, Librarian's Lair, Glittering Shrine, Vault of Secrets, Webby Corridor, Chamber of Lights, Waterfall Cave, Marble Halls, Uncanny Lair, Den of Darkness, Luminous Gardens, Nasty Passage, Chilly Mausoleum, Hall of Time and Vault of Vastness
.
You are in Rockslide Cavern
The number of viable directions is 2.

Rockslide Cavern
Boulders have tumbled down on one side of this cave. It's a tight squeeze to get by them.

You can see a lumbering mummy here.

Exits: east (Disturbing Hallway) or up (Cavern of the Lake of Tears)

>up
You're going to a VISITED room.

Unvisted: Shorehaven, Evil Archives, Librarian's Lair, Glittering Shrine, Vault of Secrets, Webby Corridor, Chamber of Lights, Waterfall Cave, Marble Halls, Uncanny Lair, Den of Darkness, Luminous Gardens, Nasty Passage, Chilly Mausoleum, Hall of Time and Vault of Vastness
.
You are in Cavern of the Lake of Tears
The number of viable directions is 2.

Cavern of the Lake of Tears
A still, deep lake stretches into the distance. It's vast. You can't see the other side.

You can see a confused adventurer here.

Exits: east (Jewelled Forest) or down (Rockslide Cavern)

>swim
The water feels great!
Ominous, like a grim battleship, you glide across the crystal waters.
You notice a little beach to the west.

Exits: east (Jewelled Forest) or west (Shorehaven) or down (Rockslide Cavern)

>w
You get out of the water.
Unvisted: Shorehaven, Evil Archives, Librarian's Lair, Glittering Shrine, Vault of Secrets, Webby Corridor, Chamber of Lights, Waterfall Cave, Marble Halls, Uncanny Lair, Den of Darkness, Luminous Gardens, Nasty Passage, Chilly Mausoleum, Hall of Time and Vault of Vastness
.
You are in Shorehaven
The number of viable directions is 1.

Shorehaven
A peaceful, secluded little beach, just the right size for a dungeon-going goose. A good place to tuck your head under your wing for a short nap.

Exits: east (Cavern of the Lake of Tears)

>e
You're going to a VISITED room.

Unvisted: Evil Archives, Librarian's Lair, Glittering Shrine, Vault of Secrets, Webby Corridor, Chamber of Lights, Waterfall Cave, Marble Halls, Uncanny Lair, Den of Darkness, Luminous Gardens, Nasty Passage, Chilly Mausoleum, Hall of Time and Vault of Vastness
.
You are in Cavern of the Lake of Tears
The number of viable directions is 2.

Cavern of the Lake of Tears
A still, deep lake stretches into the distance. It's vast. You can't see the other side.

You can see a confused adventurer here.

Exits: east (Jewelled Forest) or down (Rockslide Cavern)

>w
You can't go that way.

Exits: east (Jewelled Forest) or down (Rockslide Cavern)

>d
You're going to a VISITED room.

Unvisted: Evil Archives, Librarian's Lair, Glittering Shrine, Vault of Secrets, Webby Corridor, Chamber of Lights, Waterfall Cave, Marble Halls, Uncanny Lair, Den of Darkness, Luminous Gardens, Nasty Passage, Chilly Mausoleum, Hall of Time and Vault of Vastness
.
You are in Rockslide Cavern
The number of viable directions is 2.

Rockslide Cavern
Boulders have tumbled down on one side of this cave. It's a tight squeeze to get by them.

You can see a lumbering mummy here.

Exits: east (Disturbing Hallway) or up (Cavern of the Lake of Tears)

>up
You're going to a VISITED room.

Unvisted: Evil Archives, Librarian's Lair, Glittering Shrine, Vault of Secrets, Webby Corridor, Chamber of Lights, Waterfall Cave, Marble Halls, Uncanny Lair, Den of Darkness, Luminous Gardens, Nasty Passage, Chilly Mausoleum, Hall of Time and Vault of Vastness
.
You are in Cavern of the Lake of Tears
The number of viable directions is 2.

Cavern of the Lake of Tears
A still, deep lake stretches into the distance. It's vast. You can't see the other side.

You can see a confused adventurer here.

Exits: east (Jewelled Forest) or down (Rockslide Cavern)

>d
You're going to a VISITED room.

Unvisted: Evil Archives, Librarian's Lair, Glittering Shrine, Vault of Secrets, Webby Corridor, Chamber of Lights, Waterfall Cave, Marble Halls, Uncanny Lair, Den of Darkness, Luminous Gardens, Nasty Passage, Chilly Mausoleum, Hall of Time and Vault of Vastness
.
You are in Rockslide Cavern
The number of viable directions is 2.

Rockslide Cavern
Boulders have tumbled down on one side of this cave. It's a tight squeeze to get by them.

You can see a lumbering mummy here.

Exits: east (Disturbing Hallway) or up (Cavern of the Lake of Tears)

>e
You're going to a VISITED room.

Unvisted: Evil Archives, Librarian's Lair, Glittering Shrine, Vault of Secrets, Webby Corridor, Chamber of Lights, Waterfall Cave, Marble Halls, Uncanny Lair, Den of Darkness, Luminous Gardens, Nasty Passage, Chilly Mausoleum, Hall of Time and Vault of Vastness
.
You are in Disturbing Hallway
The number of viable directions is 2.

Disturbing Hallway
The angles here, the colors, the feel of the air -- just wrong. Horribly wrong.

You can see a tentacled horror here.

Exits: west (Rockslide Cavern) or down (Evil Archives)

>d
Unvisted: Evil Archives, Librarian's Lair, Glittering Shrine, Vault of Secrets, Webby Corridor, Chamber of Lights, Waterfall Cave, Marble Halls, Uncanny Lair, Den of Darkness, Luminous Gardens, Nasty Passage, Chilly Mausoleum, Hall of Time and Vault of Vastness
.
You are in Evil Archives
The number of viable directions is 1.
You are in Evil Archives for the FIRST time
Unpicked: Jewelled Forest, Glittering Shrine, Webby Corridor, Chamber of Lights, Waterfall Cave, Marble Halls, Uncanny Lair, Den of Darkness, Luminous Gardens, Nasty Passage, Chilly Mausoleum and Hall of Time.
~~~~ next room will be Chamber of Lights
available directions: north, south, east, west and down
available directions: north, south, east, west and down
~~~~ next direction will be north

Evil Archives
Row upon row of moldering tomes, dust, and a sense of forboding fill this underground library.

You can see a grumpy kobold here.

Exits: north (Chamber of Lights) or up (Disturbing Hallway)

>kill kobold
You viciously peck the grumpy kobold, causing 9 points of damage!
You viciously peck the grumpy kobold, causing 10 points of damage!

The grumpy kobold attacks you, causing 3 points of damage!

Exits: north (Chamber of Lights) or up (Disturbing Hallway)

>kill kobold
You viciously peck the grumpy kobold, causing 6 points of damage!

The grumpy kobold leaps back in shock.
"Ouch! I'm out of here!" it mutters.
The grumpy kobold drags itself off into the darkness.

Exits: north (Chamber of Lights) or up (Disturbing Hallway)

>n
Unvisted: Librarian's Lair, Glittering Shrine, Vault of Secrets, Webby Corridor, Chamber of Lights, Waterfall Cave, Marble Halls, Uncanny Lair, Den of Darkness, Luminous Gardens, Nasty Passage, Chilly Mausoleum, Hall of Time and Vault of Vastness
.
You are in Chamber of Lights
The number of viable directions is 1.
You are in Chamber of Lights for the FIRST time
Unpicked: Jewelled Forest, Glittering Shrine, Webby Corridor, Waterfall Cave, Marble Halls, Uncanny Lair, Den of Darkness, Luminous Gardens, Nasty Passage, Chilly Mausoleum and Hall of Time.
~~~~ next room will be Hall of Time
available directions: north, south, east, west and down
removing south because you just came from there 
available directions: north, east, west and down
~~~~ next direction will be east

Chamber of Lights
An uncanny mottled glow emanates from the walls of this high-ceilinged cavern.

Exits: south (Evil Archives) or east (Hall of Time)

>e
Unvisted: Librarian's Lair, Glittering Shrine, Vault of Secrets, Webby Corridor, Waterfall Cave, Marble Halls, Uncanny Lair, Den of Darkness, Luminous Gardens, Nasty Passage, Chilly Mausoleum, Hall of Time and Vault of Vastness
.
You are in the Hall of Time
The number of viable directions is 1.
You are in the Hall of Time for the FIRST time
Unpicked: Jewelled Forest, Glittering Shrine, Webby Corridor, Waterfall Cave, Marble Halls, Uncanny Lair, Den of Darkness, Luminous Gardens, Nasty Passage and Chilly Mausoleum.
~~~~ next room will be Waterfall Cave
available directions: north, south, east, west and down
removing west because you just came from there 
available directions: north, south, east and down
~~~~ next direction will be north

Hall of Time
A long, narrow hall, flickering with light from magefire sconces. The painted walls show the progression of time through planets and stars, sun and moons.

Exits: north (Waterfall Cave) or west (Chamber of Lights)

>n
Unvisted: Librarian's Lair, Glittering Shrine, Vault of Secrets, Webby Corridor, Waterfall Cave, Marble Halls, Uncanny Lair, Den of Darkness, Luminous Gardens, Nasty Passage, Chilly Mausoleum and Vault of Vastness
.
You are in Waterfall Cave
The number of viable directions is 1.
You are in Waterfall Cave for the FIRST time
Unpicked: Jewelled Forest, Glittering Shrine, Webby Corridor, Marble Halls, Uncanny Lair, Den of Darkness, Luminous Gardens, Nasty Passage and Chilly Mausoleum.
~~~~ next room will be Webby Corridor
available directions: north, south, east, west and down
removing south because you just came from there 
available directions: north, east, west and down
~~~~ next direction will be east

Waterfall Cave
Water pours down from high above, catching on stalactites and glinting in the eerie glow from the walls. A little pool lies underneath.

Exits: south (Hall of Time) or east (Webby Corridor)

>e
Unvisted: Librarian's Lair, Glittering Shrine, Vault of Secrets, Webby Corridor, Marble Halls, Uncanny Lair, Den of Darkness, Luminous Gardens, Nasty Passage, Chilly Mausoleum and Vault of Vastness
.
You are in Webby Corridor
The number of viable directions is 1.
You are in Webby Corridor for the FIRST time
Unpicked: Jewelled Forest, Glittering Shrine, Marble Halls, Uncanny Lair, Den of Darkness, Luminous Gardens, Nasty Passage and Chilly Mausoleum.
~~~~ next room will be Den of Darkness
available directions: north, south, east, west and down
removing west because you just came from there 
available directions: north, south, east and down
~~~~ next direction will be east

Webby Corridor
Dusty ropes of thick spiderweb festoon the walls.

Exits: east (Den of Darkness) or west (Waterfall Cave)

>e
Unvisted: Librarian's Lair, Glittering Shrine, Vault of Secrets, Marble Halls, Uncanny Lair, Den of Darkness, Luminous Gardens, Nasty Passage, Chilly Mausoleum and Vault of Vastness
.
You are in Den of Darkness
The number of viable directions is 1.
You are in Den of Darkness for the FIRST time
Unpicked: Jewelled Forest, Glittering Shrine, Marble Halls, Uncanny Lair, Luminous Gardens, Nasty Passage and Chilly Mausoleum.
~~~~ next room will be Luminous Gardens
available directions: north, south, east, west and down
removing west because you just came from there 
available directions: north, south, east and down
~~~~ next direction will be south

Den of Darkness
The darkness softens, the room is hushed. It's hard to see your way out.

Exits: south (Luminous Gardens) or west (Webby Corridor)

>s
Unvisted: Librarian's Lair, Glittering Shrine, Vault of Secrets, Marble Halls, Uncanny Lair, Luminous Gardens, Nasty Passage, Chilly Mausoleum and Vault of Vastness
.
You are in Luminous Gardens
The number of viable directions is 1.
You are in Luminous Gardens for the FIRST time
Unpicked: Jewelled Forest, Glittering Shrine, Marble Halls, Uncanny Lair, Nasty Passage and Chilly Mausoleum.
~~~~ next room will be Marble Halls
available directions: north, south, east, west and down
removing north because you just came from there 
available directions: south, east, west and down
~~~~ next direction will be east

Luminous Gardens
Mushrooms the size of trees, glowing, are scattered among winding paths. Tiny lightning bugs flit between snow-pale cave blossoms.

Exits: north (Den of Darkness) or east (Marble Halls)

>e
Unvisted: Librarian's Lair, Glittering Shrine, Vault of Secrets, Marble Halls, Uncanny Lair, Nasty Passage, Chilly Mausoleum and Vault of Vastness
.
You are in Marble Halls
The number of viable directions is 1.
You are in Marble Halls for the FIRST time
Unpicked: Jewelled Forest, Glittering Shrine, Uncanny Lair, Nasty Passage and Chilly Mausoleum.
~~~~ next room will be Jewelled Forest
available directions: north, south, east, west and down
removing west because you just came from there 
available directions: north, south, east and down
~~~~ next direction will be north

Marble Halls
White flowstone gleams in thick curtains on the walls of this magnificent hall.

Exits: north (Jewelled Forest) or west (Luminous Gardens)

>n
You're going to a VISITED room.

Unvisted: Librarian's Lair, Glittering Shrine, Vault of Secrets, Uncanny Lair, Nasty Passage, Chilly Mausoleum and Vault of Vastness
.
You are in Jewelled Forest
The number of viable directions is 3.

Jewelled Forest
Marvellous columns march down the length of this immense cave. Jewel-like lights shine from deep within.

Exits: north (Dungeon Entrance) or south (Marble Halls) or west (Cavern of the Lake of Tears)

* * *

>d
You waddle valiantly forth.

The walls rumble. Rocks fall.
You can't see the sky anymore!
There is no way out.

Dungeon Entrance
Stone walls, mildewed with glowing stuff, widen into a large cold room. 

A large, colorful sign is on the wall.

You can see a healing potion and a trophy case (closed) here.

Exits: east (Rockslide Cavern)

>peck mummy
You viciously peck the lumbering mummy, causing 10 points of damage!
You viciously peck the lumbering mummy, causing 8 points of damage!

The lumbering mummy falls over, gasping in pain.
"The dispatcher didn't warn us! This is too much!" it whines, cringing.
The lumbering mummy drags itself off into the darkness.

Exits: west (Webby Corridor)

[Your score has just gone up by one point.]

>peck rat
You viciously peck the giant rat, causing 9 points of damage!

The giant rat falls over, gasping in pain.
"Scare the adventurers, they said, it's easy, they said," it yelps.
The giant rat drags itself off into the darkness.

Exits: west (Webby Corridor)

[Your score has just gone up by one point.]

>w
The number of viable directions is 1.
removing east because you just came from there 

Webby Corridor
Dusty ropes of thick spiderweb festoon the walls.

You can see a wispy ghost here.

Exits: south (Uncanny Lair) or east (Dungeon Entrance)

>peck ghost
You viciously peck the wispy ghost, causing 3 points of damage!
You viciously peck the wispy ghost, causing 9 points of damage!

The wispy ghost attacks you, causing 3 points of damage!

Exits: south (Uncanny Lair) or east (Dungeon Entrance)

>peck ghost
You viciously peck the wispy ghost, causing 10 points of damage!

The wispy ghost trips and falls.
"Ouch! I'm out of here!" it yells.
The wispy ghost drags itself off into the darkness.

Exits: south (Uncanny Lair) or east (Dungeon Entrance)

[Your score has just gone up by one point.]

>s
The number of viable directions is 1.
removing north because you just came from there 

Uncanny Lair
Oddly shaped bones are strewn about this rough cave. Some creature made a nest in one corner out of shredded fungus.

You can see a glowering elf here.

Exits: north (Webby Corridor) or down (Cavern of the Lake of Tears)

>peck elf
You viciously peck the glowering elf, causing 3 points of damage!
You viciously peck the glowering elf, causing 10 points of damage!

The glowering elf attacks you, causing 3 points of damage!
The glowering elf attacks you, causing 5 points of damage!

You swoon.
The world shimmers and whirls.
You wake up nestled into a hollow of warm sand.
You feel completely healed after your nap.

Shorehaven
A peaceful, secluded little beach, just the right size for a dungeon-going goose. A good place to tuck your head under your wing for a short nap. Or you can swim out into the lake.

>swim
The water feels great!
Ominous, like a grim battleship, you glide across the crystal waters.

Cavern of the Lake of Tears
A still, deep lake stretches into the distance. It's vast. You can't see the other side.

~~~~ next direction will be west

Exits: east (Cavern of the Lake of Tears) or west (Cavern of the Lake of Tears) or up (Uncanny Lair)

* * *

>d
You waddle valiantly forth.

The walls rumble. Rocks fall.
You can't see the sky anymore!
There is no way out.

Dungeon Entrance
Stone walls, mildewed with glowing stuff, widen into a large cold room. 

A large, colorful sign is on the wall.

You can see a healing potion and a trophy case (closed) here.

Exits: east (Rockslide Cavern)

>peck rat
You viciously peck the giant rat, causing 3 points of damage!
You viciously peck the giant rat, causing 3 points of damage!

The giant rat trips and falls.
"This isn't how things are supposed to go!" it shrieks.
The giant rat drags itself off into the darkness.

Exits: down (Rockslide Cavern)

[Your score has just gone up by one point.]

>d
Rockslide Cavern
Boulders have tumbled down on one side of this cave. It's a tight squeeze to get by them.

You can see an AirDnD lanyard here.

Exits: west (Evil Archives) or up (Dungeon Entrance)

>d
Hall of Time
A long, narrow hall, flickering with light from magefire sconces. The painted walls show the progression of time through planets and stars, sun and moons.

You can see an iridium bat here.

Exits: west (Chamber of Lights) or up (Marble Halls)

>peck bat
You viciously peck the iridium bat, causing 9 points of damage!
You viciously peck the iridium bat, causing 10 points of damage!

The iridium bat leaps back in shock.
"Scare the adventurers, they said, it's easy, they said," it mutters as it turns to run.
The iridium bat drags itself off into the darkness.

Exits: west (Chamber of Lights) or up (Marble Halls)

>w
Chamber of Lights
An uncanny mottled glow emanates from the walls of this high-ceilinged cavern.

You can see a tentacled horror here.

Exits: east (Hall of Time) or down (Disturbing Hallway)

>d
Disturbing Hallway
The angles here, the colors, the feel of the air -- just wrong. Horribly wrong.

You can see a grumpy kobold here.

Exits: south (Webby Corridor) or up (Chamber of Lights)

>s
Webby Corridor
Dusty ropes of thick spiderweb festoon the walls.

Exits: north (Disturbing Hallway) or down (Uncanny Lair)

>d
Uncanny Lair
Oddly shaped bones are strewn about this rough cave. Some creature made a nest in one corner out of shredded fungus.

Exits: south (Evil Archives) or up (Webby Corridor)

>s
Evil Archives
Row upon row of moldering tomes, dust, and a sense of forboding fill this underground library.

Exits: north (Uncanny Lair) or down (Waterfall Cave)

>d
Waterfall Cave
Water pours down from high above, catching on stalactites and glinting in the eerie glow from the walls. A little pool lies underneath.

Exits: up (Evil Archives) or down (Jewelled Forest)

>d
Jewelled Forest
Marvellous columns march down the length of this immense cavern. Jewel-like lights shine from deep within.

Exits: east (Den of Darkness) or west (Cavern of the Lake of Tears) or up (Waterfall Cave)

>l
Jewelled Forest
Marvellous columns march down the length of this immense cavern. Jewel-like lights shine from deep within.

Exits: east (Den of Darkness) or west (Cavern of the Lake of Tears) or up (Waterfall Cave)

>e
Den of Darkness
The darkness softens, the room is hushed. It's hard to see your way out.

You can see a gelatinous cube here.

Exits: east (Chilly Mausoleum) or west (Jewelled Forest)

>peck cube
You viciously peck the gelatinous cube, causing 10 points of damage!
You viciously peck the gelatinous cube, causing 3 points of damage!

The gelatinous cube attacks you, causing 4 points of damage!

Exits: east (Chilly Mausoleum) or west (Jewelled Forest)

>peck cube
You viciously peck the gelatinous cube, causing 5 points of damage!
You viciously peck the gelatinous cube, causing 8 points of damage!

The gelatinous cube leaps back in shock.
"Mama always told me never to cross a dungeon picket line," it mutters.
The gelatinous cube drags itself off into the darkness.

Exits: east (Chilly Mausoleum) or west (Jewelled Forest)

>e
Chilly Mausoleum
Cold seeps into your bones. Faceless tombs loom overhead.

Exits: west (Den of Darkness) or down (Luminous Gardens)

>d
Luminous Gardens
Mushrooms the size of trees, glowing, are scattered among winding paths. Tiny lightning bugs flit between snow-pale cave blossoms.

You can see a spider here.

Exits: up (Chilly Mausoleum) or down (Nasty Passage)

>peck spider
You viciously peck the spider, causing 7 points of damage!
You viciously peck the spider, causing 6 points of damage!

The spider attacks you, causing 1 points of damage!

Exits: up (Chilly Mausoleum) or down (Nasty Passage)

>peck spider
You viciously peck the spider, causing 10 points of damage!

The spider trips and falls.
"Level 1 humans only, that's what they promised," it whines, cringing.
The spider drags itself off into the darkness.

Exits: up (Chilly Mausoleum) or down (Nasty Passage)

>d
Nasty Passage
A tight squeeze between damp and slimy boulders. There is blood on the ground.

Exits: west (Rockslide Cavern) or up (Luminous Gardens)

>w
Rockslide Cavern
Boulders have tumbled down on one side of this cave. It's a tight squeeze to get by them.

Exits: north (Glittering Shrine) or east (Nasty Passage)

>n
You have reached a dead end.
Something stirs in the darkness.

Exits: south (Rockslide Cavern)

>l
Glittering Shrine
Flecks of shining mica gleam from granite walls.

You can see a rainbow dragon and an obsidian altar here.

Exits: south (Rockslide Cavern)

>x altar
A slab of black glass forms an altar along one wall. An inscription runs along its rim.

Exits: south (Rockslide Cavern)

>x dragon
You see nothing special about the rainbow dragon.

Exits: south (Rockslide Cavern)

>peck dragon
You sidle up to the dragon and give it a little nudge.
The dragon wakes up. It yawns hugely.

Exits: south (Rockslide Cavern)

>l
Glittering Shrine
Flecks of shining mica gleam from granite walls.

You can see a rainbow dragon and an obsidian altar here.

Exits: south (Rockslide Cavern)

>peck dragon
You stretch out your neck to attack the dragon, then reconsider.
The dragon looks at you.

Exits: south (Rockslide Cavern)

>l
Glittering Shrine
Flecks of shining mica gleam from granite walls.

You can see a rainbow dragon and an obsidian altar here.

Exits: south (Rockslide Cavern)

>s
Exits: north (Glittering Shrine) or east (Nasty Passage)

>e
Exits: west (Rockslide Cavern) or up (Luminous Gardens)

>up
Exits: up (Chilly Mausoleum) or down (Nasty Passage)

>up
Exits: west (Den of Darkness) or down (Luminous Gardens)

>w
Exits: east (Chilly Mausoleum) or west (Jewelled Forest)

>w
Exits: east (Den of Darkness) or west (Cavern of the Lake of Tears) or up (Waterfall Cave)

>w
You have reached a dead end.
Something stirs in the darkness.

Exits: east (Jewelled Forest)

>l
Cavern of the Lake of Tears
A still, deep lake stretches into the distance. It's vast. You can't see the other side.

You can see a rainbow dragon here.

Exits: east (Jewelled Forest)

* * *

>d
Rockslide Cavern
Boulders have tumbled down on one side of this cave. It's a tight squeeze to get by them.

You can see an AirDnD lanyard here.

Exits: west (Evil Archives) or up (Dungeon Entrance)

>peck elf
You viciously peck the glowering elf, causing 8 points of damage!
You viciously peck the glowering elf, causing 10 points of damage!

The glowering elf attacks you, causing 5 points of damage!
The glowering elf attacks you, causing 4 points of damage!

Exits: up (Dungeon Entrance) or down (Den of Darkness)

>peck elf
You viciously peck the glowering elf, causing 7 points of damage!
You viciously peck the glowering elf, causing 9 points of damage!

The glowering elf trips and falls.
.
"I went to Monster Polytechnic for this?" it yells.
The glowering elf drags itself off into the darkness.

Exits: up (Dungeon Entrance) or down (Den of Darkness)

* * *

>d
Rockslide Cavern
Boulders have tumbled down on one side of this cave. It's a tight squeeze to get by them.

You can see an AirDnD lanyard here.

Exits: west (Evil Archives) or up (Dungeon Entrance)

>s
Jewelled Forest
Marvellous columns march down the length of this immense cavern. Jewel-like lights shine from deep within.

Exits: north (Vault of Vastness) or south (Waterfall Cave) or west (Cavern of the Lake of Tears)

>s
Waterfall Cave
Water pours down from high above, catching on stalactites and glinting in the eerie glow from the walls. A little pool lies underneath.

Exits: north (Jewelled Forest) or south (Chilly Mausoleum)

>swim
The water feels great!
Ominous, like a grim battleship, you glide across the crystal waters.

Exits: north (Jewelled Forest) or south (Chilly Mausoleum)

>s
You get out of the water.

Chilly Mausoleum
Cold seeps into your bones. Faceless tombs loom overhead.

Exits: north (Waterfall Cave) or west (Hall of Time)

>w
Hall of Time
A long, narrow hall, flickering with light from magefire sconces. The painted walls show the progression of time through planets and stars, sun and moons.

Exits: north (Chamber of Lights) or east (Chilly Mausoleum)

>n
Chamber of Lights
An uncanny mottled glow emanates from the walls of this high-ceilinged cavern.

You can see a wispy ghost here.

Exits: north (Rockslide Cavern) or south (Hall of Time)

>peck ghost
You viciously peck the wispy ghost, causing 4 points of damage!
You viciously peck the wispy ghost, causing 7 points of damage!

The wispy ghost attacks you, causing 4 points of damage!

Exits: north (Rockslide Cavern) or south (Hall of Time)

>peck ghost
You viciously peck the wispy ghost, causing 5 points of damage!

The wispy ghost falls over, gasping in pain.
"I went to Monster Polytechnic for this?" it yells.
It drags itself off into the darkness.

Exits: north (Rockslide Cavern) or south (Hall of Time)

* * *

>d
Rockslide Cavern
Boulders have tumbled down on one side of this cave. It's a tight squeeze to get by them.

You can see an AirDnD lanyard here.

Exits: west (Evil Archives) or up (Dungeon Entrance)

>take lanyard
Taken.

Exits: west (Evil Archives) or up (Dungeon Entrance)

>stats
Strength: 3   Ferocity: 2   HP: 10/10 

Exits: west (Evil Archives) or up (Dungeon Entrance)

>wear lanyard
Exits: west (Evil Archives) or up (Dungeon Entrance)

>stats
Strength: 3   Ferocity: 3   HP: 10/10 

Exits: west (Evil Archives) or up (Dungeon Entrance)

>w
removing east because you just came from there 

Evil Archives
Row upon row of moldering tomes, dust, and a sense of forboding fill this underground library.

Exits: north (Cavern of the Lake of Tears) or east (Rockslide Cavern)

>n
removing south because you just came from there 

Cavern of the Lake of Tears
A still, deep lake stretches into the distance. It's vast. You can't see the other side.

You can see an AirDnD headlamp and a gelatinous cube here.

Exits: south (Evil Archives) or down (Hall of Time)

>take all
AirDnD headlamp: Taken.

Exits: south (Evil Archives) or down (Hall of Time)

>wear headlamp
Exits: south (Evil Archives) or down (Hall of Time)

>stats
Strength: 4   Ferocity: 3   HP: 10/10 

Exits: south (Evil Archives) or down (Hall of Time)

>x self
You crane your long, graceful neck to look back. 
White, muscular, hefty, feathered. 
Yes, you're still a fabulous goose!

Exits: south (Evil Archives) or down (Hall of Time)

* * *

>d
Rockslide Cavern
Boulders have tumbled down on one side of this cave. It's a tight squeeze to get by them.

You can see an AirDnD lanyard here.

Exits: west (Evil Archives) or up (Dungeon Entrance)

>w
You can't go that way.

Exits: north (Luminous Gardens)

>peck ghost
You can't see any such thing.

>w
You can't go that way.

Exits: north (Luminous Gardens)

>s
You can't go that way.

Exits: north (Luminous Gardens)

>peck adventurer
You can't see any such thing.

>peck adventurer
You can't see any such thing.

>e
You can't go that way.

Exits: north (Luminous Gardens)

>nap
You take a quick snooze and wake up again, feeling frisky.

Exits: north (Luminous Gardens)

>swim
Exits: north (Luminous Gardens)

>l
Dungeon Entrance
Stone walls, mildewed with glowing stuff, widen into a large bare room.

You can see a cave snake and a trophy case (empty) here.

Exits: north (Luminous Gardens)

>peck snake
You viciously peck the cave snake, causing 10 points of damage!
You viciously peck the cave snake, causing 7 points of damage!

The cave snake falls over, gasping in pain.
"Scare the adventurers, they said, it's easy, they said," it shrieks, scuttling away.
The cave snake drags itself off into the darkness.

Exits: north (Luminous Gardens)

[Your score has just gone up by one point.]

>l
Dungeon Entrance
Stone walls, mildewed with glowing stuff, widen into a large bare room.

You can see a trophy case (empty) here.

Exits: north (Luminous Gardens)

>n
The number of viable directions is 1.
removing south because you just came from there 

Luminous Gardens
Mushrooms the size of trees, glowing, are scattered among winding paths. Tiny lightning bugs flit between snow-pale cave blossoms.

You can see a spider here.

Exits: south (Dungeon Entrance) or west (Chilly Mausoleum)

>peck spider
You viciously peck the spider, causing 10 points of damage!
You viciously peck the spider, causing 4 points of damage!

The spider attacks you, causing 2 points of damage!

Exits: south (Dungeon Entrance) or west (Chilly Mausoleum)

>peck spider
You viciously peck the spider, causing 6 points of damage!

The spider falls over, gasping in pain.
"Ouch! I'm out of here!" it yelps.
The spider drags itself off into the darkness.

Exits: south (Dungeon Entrance) or west (Chilly Mausoleum)

[Your score has just gone up by one point.]

>w
The number of viable directions is 1.
removing east because you just came from there 

Chilly Mausoleum
Cold seeps into your bones. Faceless tombs loom overhead.

You can see an iridium bat here.

Exits: east (Luminous Gardens) or down (Waterfall Cave)

>peck bat
You viciously peck the iridium bat, causing 7 points of damage!
You viciously peck the iridium bat, causing 3 points of damage!

The iridium bat attacks you, causing 4 points of damage!

Exits: east (Luminous Gardens) or down (Waterfall Cave)

>peck bat
You viciously peck the iridium bat, causing 7 points of damage!

The iridium bat trips and falls.
"Mama always told me never to cross a dungeon picket line," it mutters.
The iridium bat drags itself off into the darkness.

Exits: east (Luminous Gardens) or down (Waterfall Cave)

[Your score has just gone up by one point.]

>d
The number of viable directions is 1.

Waterfall Cave
Water pours down from high above, catching on stalactites and glinting in the eerie glow from the walls. A little pool lies underneath.

Exits: east (Jewelled Forest) or up (Chilly Mausoleum)

>e
The number of viable directions is 1.
removing west because you just came from there 

Jewelled Forest
Marvellous columns march down the length of this immense cave. Jewel-like lights shine from deep within.

Exits: east (Webby Corridor) or west (Waterfall Cave)

>e
The number of viable directions is 1.
removing west because you just came from there 

Webby Corridor
Dusty ropes of thick spiderweb festoon the walls.

Exits: south (Cavern of the Lake of Tears) or west (Jewelled Forest)

>s
The number of viable directions is 1.
removing north because you just came from there 

Cavern of the Lake of Tears
A still, deep lake stretches into the distance. It's vast. You can't see the other side.

Exits: north (Webby Corridor) or down (Evil Archives)

>swim
The water feels great!
Ominous, like a grim battleship, you glide across the crystal waters.

Exits: north (Webby Corridor) or down (Evil Archives)

>d
You get out of the water.
The number of viable directions is 1.

Evil Archives
Row upon row of moldering tomes, dust, and a sense of forboding fill this underground library.

You can see a grumpy kobold here.

Exits: up (Cavern of the Lake of Tears) or down (Den of Darkness)

>peck kobold
You viciously peck the grumpy kobold, causing 3 points of damage!
You viciously peck the grumpy kobold, causing 7 points of damage!

The grumpy kobold attacks you, causing 2 points of damage!

Exits: up (Cavern of the Lake of Tears) or down (Den of Darkness)

>peck kobold
You viciously peck the grumpy kobold, causing 3 points of damage!
You viciously peck the grumpy kobold, causing 5 points of damage!

The grumpy kobold attacks you, causing 3 points of damage!

You swoon.
The world shimmers and whirls.
You wake up nestled into a hollow of warm sand.
You feel completely healed after your nap.

Shorehaven
A peaceful, secluded little beach, just the right size for a dungeon-going goose. A good place to tuck your head under your wing for a short nap. Or you can swim out into the lake.

>stats
Strength: 3   Ferocity: 2   HP: 10/10

* * *

>l
Shorehaven
A peaceful, secluded little beach, just the right size for a dungeon-going goose. A good place to tuck your head under your wing for a short nap. Or you can swim out into the lake.

* * *

>w
You can't go that way.

Exits: north (Luminous Gardens)

>swim
The water feels great!
Ominous, like a grim battleship, you glide across the crystal waters.
You notice a little beach to the west.

Exits: east (Jewelled Forest) or west (Shorehaven) or down (Evil Archives)

>w
You get out of the water.
You are in Shorehaven
The number of viable directions is 1.

Shorehaven
A peaceful, secluded little beach, just the right size for a dungeon-going goose. A good place to tuck your head under your wing for a short nap.

Exits: east (Cavern of the Lake of Tears)

>e
You're going to a VISITED room.

You are in Cavern of the Lake of Tears
The number of viable directions is 2.

Cavern of the Lake of Tears
A still, deep lake stretches into the distance. It's vast. You can't see the other side.

Exits: east (Jewelled Forest) or down (Evil Archives)

>d
You are in Evil Archives
The number of viable directions is 1.
You are in Evil Archives for the FIRST time
~~~~ next room will be Rockslide Cavern
available directions: north, south, east, west and down
~~~~ next direction will be south

Evil Archives
Row upon row of moldering tomes, dust, and a sense of forboding fill this underground library.

Exits: south (Rockslide Cavern) or up (Cavern of the Lake of Tears)

>up
You're going to a VISITED room.

You are in Cavern of the Lake of Tears
The number of viable directions is 2.

Cavern of the Lake of Tears
A still, deep lake stretches into the distance. It's vast. You can't see the other side.

Exits: east (Jewelled Forest) or down (Evil Archives)

* * *

>peck rat
You viciously peck the giant rat, causing 3 points of damage!
You viciously peck the giant rat, causing 3 points of damage!

The giant rat trips and falls.
"This isn't how things are supposed to go!" it shrieks.
The giant rat drags itself off into the darkness.

Exits: down (Rockslide Cavern)

[Your score has just gone up by one point.]

>e
The number of viable directions is 1.
removing west because you just came from there 

Disturbing Hallway
The angles here, the colors, the feel of the air -- just wrong. Horribly wrong.

Exits: east (Webby Corridor) or west (Dungeon Entrance)

>d
You are in Waterfall Cave
The number of viable directions is 1.
You are in Waterfall Cave for the FIRST time
~~~~ next room will be Rockslide Cavern
available directions: north, south, east, west and down
~~~~ next direction will be north

Waterfall Cave
Water pours down from high above, catching on stalactites and glinting in the eerie glow from the walls. A little pool lies underneath.

You can see a soot sprite here.

Exits: north (Rockslide Cavern) or up (Chilly Mausoleum)

>get on altar
That's not something you can enter.

Exits: west (Chamber of Lights) or up (Den of Darkness)

>stand on altar
That's not something you can stand on.

Exits: west (Chamber of Lights) or up (Den of Darkness)

* * *

>d
You are in Waterfall Cave
The number of viable directions is 1.
You are in Waterfall Cave for the FIRST time
~~~~ next room will be Rockslide Cavern
available directions: north, south, east, west and down
~~~~ next direction will be north

Waterfall Cave
Water pours down from high above, catching on stalactites and glinting in the eerie glow from the walls. A little pool lies underneath.

You can see a soot sprite here.

Exits: north (Rockslide Cavern) or up (Chilly Mausoleum)

>peck sprite
You viciously peck the soot sprite, causing 8 points of damage!
You viciously peck the soot sprite, causing 8 points of damage!

The soot sprite leaps back in shock.
"Level 1 humans only, that's what they promised," it shrieks, scuttling away.
The soot sprite drags itself off into the darkness.

Exits: north (Rockslide Cavern) or up (Chilly Mausoleum)

>n
You are in Rockslide Cavern
The number of viable directions is 1.
You are in Rockslide Cavern for the FIRST time
~~~~ next room will be Glittering Shrine
available directions: north, south, east, west and down
removing south because you just came from there 
~~~~ next direction will be down

Rockslide Cavern
Boulders have tumbled down on one side of this cave. It's a tight squeeze to get by them.

You can see a grumpy kobold here.

Exits: south (Waterfall Cave) or down (Glittering Shrine)

>peck kobold
You viciously peck the grumpy kobold, causing 7 points of damage!
You viciously peck the grumpy kobold, causing 6 points of damage!

The grumpy kobold attacks you, causing 2 points of damage!

Exits: south (Waterfall Cave) or down (Glittering Shrine)

>d
You are in Glittering Shrine
The number of viable directions is 1.
You are in Glittering Shrine for the FIRST time
~~~~ next room will be Chamber of Lights
available directions: north, south, east, west and down
~~~~ next direction will be north

Glittering Shrine
Flecks of shining mica gleam from granite walls.

You can see a lumbering mummy and an obsidian altar here.

Exits: north (Chamber of Lights) or up (Rockslide Cavern)

>peck mummy
You viciously peck the lumbering mummy, causing 6 points of damage!
You viciously peck the lumbering mummy, causing 5 points of damage!

The lumbering mummy attacks you, causing 3 points of damage!

Exits: north (Chamber of Lights) or up (Rockslide Cavern)

>peck mummy
You viciously peck the lumbering mummy, causing 5 points of damage!

The lumbering mummy falls over, gasping in pain.
"I went to Monster Polytechnic for this?" it mutters.
The lumbering mummy drags itself off into the darkness.

Exits: north (Chamber of Lights) or up (Rockslide Cavern)

>n
You are in Chamber of Lights
The number of viable directions is 1.
You are in Chamber of Lights for the FIRST time
~~~~ next room will be Disturbing Hallway
available directions: north, south, east, west and down
removing south because you just came from there 
~~~~ next direction will be west

Chamber of Lights
An uncanny mottled glow emanates from the walls of this high-ceilinged cavern.

Exits: south (Glittering Shrine) or west (Disturbing Hallway)

>w
You are in Disturbing Hallway
The number of viable directions is 1.
You are in Disturbing Hallway for the FIRST time
~~~~ next room will be Webby Corridor
available directions: north, south, east, west and down
removing east because you just came from there 
~~~~ next direction will be south

Disturbing Hallway
The angles here, the colors, the feel of the air -- just wrong. Horribly wrong.

Exits: south (Webby Corridor) or east (Chamber of Lights)

>s
You are in Webby Corridor
The number of viable directions is 1.
You are in Webby Corridor for the FIRST time
~~~~ next room will be Nasty Passage
available directions: north, south, east, west and down
removing north because you just came from there 
~~~~ next direction will be west

Webby Corridor
Dusty ropes of thick spiderweb festoon the walls.

You can see a confused adventurer here.

Exits: north (Disturbing Hallway) or west (Nasty Passage)

>peck adventurer
You viciously peck the confused adventurer, causing 10 points of damage!
You viciously peck the confused adventurer, causing 9 points of damage!

The confused adventurer attacks you, causing 4 points of damage!

Exits: north (Disturbing Hallway) or west (Nasty Passage)

>peck adventurer
You viciously peck the confused adventurer, causing 4 points of damage!
You viciously peck the confused adventurer, causing 3 points of damage!

The confused adventurer falls over, gasping in pain.
"Ow, that's going too far!" it mutters as it turns to run.
The confused adventurer drags itself off into the darkness.

Exits: north (Disturbing Hallway) or west (Nasty Passage)

>stats
Strength: 3   Ferocity: 2   HP: 1/10 

Exits: north (Disturbing Hallway) or west (Nasty Passage)

>w
You are in Nasty Passage
The number of viable directions is 1.
You are in Nasty Passage for the FIRST time
~~~~ next room will be Den of Darkness
available directions: north, south, east, west and down
removing east because you just came from there 
~~~~ next direction will be west

Nasty Passage
A tight squeeze between damp and slimy boulders. There is blood on the ground.

You can see a spider here.

Exits: east (Webby Corridor) or west (Den of Darkness)

>peck spider
You viciously peck the spider, causing 8 points of damage!
You viciously peck the spider, causing 4 points of damage!

The spider attacks you, causing 2 points of damage!

You swoon.
The world shimmers and whirls.
You wake up nestled into a hollow of warm sand.
You feel completely healed after your nap.

Shorehaven
A peaceful, secluded little beach, just the right size for a dungeon-going goose. A good place to tuck your head under your wing for a short nap.

Exits: east (Cavern of the Lake of Tears)

>e
You are in Cavern of the Lake of Tears
The number of viable directions is 1.
You are in Cavern of the Lake of Tears for the FIRST time
~~~~ next room will be Luminous Gardens
available directions: north, south, east, west and down
removing east because you just came from there 
~~~~ next direction will be north

Cavern of the Lake of Tears
A still, deep lake stretches into the distance. It's vast. You can't see the other side.

Exits: north (Luminous Gardens) or east (Jewelled Forest)

>n
You are in Luminous Gardens
The number of viable directions is 1.
You are in Luminous Gardens for the FIRST time
~~~~ next room will be Den of Darkness
available directions: north, south, east, west and down
removing south because you just came from there 
~~~~ next direction will be west

Luminous Gardens
Mushrooms the size of trees, glowing, are scattered among winding paths. Tiny lightning bugs flit between snow-pale cave blossoms.

Exits: south (Cavern of the Lake of Tears) or west (Den of Darkness)

>w
You are in Den of Darkness
The number of viable directions is 1.
You are in Den of Darkness for the FIRST time
~~~~ next room will be Hall of Time
available directions: north, south, east, west and down
removing east because you just came from there 
~~~~ next direction will be north

Den of Darkness
The darkness softens, the room is hushed. It's hard to see your way out.

Exits: north (Hall of Time) or east (Luminous Gardens)

>n
You are in the Hall of Time
The number of viable directions is 1.
You are in the Hall of Time for the FIRST time
~~~~ next room will be Uncanny Lair
available directions: north, south, east, west and down
removing south because you just came from there 
~~~~ next direction will be north

Hall of Time
A long, narrow hall, flickering with light from magefire sconces. The painted walls show the progression of time through planets and stars, sun and moons.

You can see a glowering elf here.

Exits: north (Uncanny Lair) or south (Den of Darkness)

>peck elf
You viciously peck the glowering elf, causing 3 points of damage!
You viciously peck the glowering elf, causing 3 points of damage!

The glowering elf attacks you, causing 3 points of damage!
The glowering elf attacks you, causing 4 points of damage!

Exits: north (Uncanny Lair) or south (Den of Darkness)

>s
You're going to a VISITED room.

You are in Den of Darkness
The number of viable directions is 2.

Den of Darkness
The darkness softens, the room is hushed. It's hard to see your way out.

Exits: north (Hall of Time) or east (Luminous Gardens)

>e
You're going to a VISITED room.

You are in Luminous Gardens
The number of viable directions is 2.

Luminous Gardens
Mushrooms the size of trees, glowing, are scattered among winding paths. Tiny lightning bugs flit between snow-pale cave blossoms.

Exits: south (Cavern of the Lake of Tears) or west (Den of Darkness)

>s
You're going to a VISITED room.

You are in Cavern of the Lake of Tears
The number of viable directions is 2.

Cavern of the Lake of Tears
A still, deep lake stretches into the distance. It's vast. You can't see the other side.

Exits: north (Luminous Gardens) or east (Jewelled Forest)

>swim
The water feels great!
Ominous, like a grim battleship, you glide across the crystal waters.
You notice a little beach to the west.

Exits: north (Luminous Gardens) or east (Jewelled Forest) or west (Shorehaven)

>w
You're going to a VISITED room.

You get out of the water.
You are in Shorehaven
The number of viable directions is 1.

Shorehaven
A peaceful, secluded little beach, just the right size for a dungeon-going goose. A good place to tuck your head under your wing for a short nap.

Exits: east (Cavern of the Lake of Tears)

>e
You're going to a VISITED room.

You are in Cavern of the Lake of Tears
The number of viable directions is 2.

Cavern of the Lake of Tears
A still, deep lake stretches into the distance. It's vast. You can't see the other side.

Exits: north (Luminous Gardens) or east (Jewelled Forest)

>e
You are in Jewelled Forest
The number of viable directions is 1.
You are in Jewelled Forest for the FIRST time
~~~~ next room will be Uncanny Lair
available directions: north, south, east, west and down
removing west because you just came from there 
~~~~ next direction will be south

Jewelled Forest
Marvellous columns march down the length of this immense cave. Jewel-like lights shine from deep within.

Exits: south (Uncanny Lair) or west (Cavern of the Lake of Tears)

>s
You are in Uncanny Lair
The number of viable directions is 2.

Uncanny Lair
Oddly shaped bones are strewn about this rough cave. Some creature made a nest in one corner out of shredded fungus.

Exits: north (Jewelled Forest) or south (Hall of Time)

>s
You're going to a VISITED room.

You are in the Hall of Time
The number of viable directions is 2.

Hall of Time
A long, narrow hall, flickering with light from magefire sconces. The painted walls show the progression of time through planets and stars, sun and moons.

You can see a glowering elf here.

Exits: north (Uncanny Lair) or south (Den of Darkness)

>s
You're going to a VISITED room.

You are in Den of Darkness
The number of viable directions is 2.

Den of Darkness
The darkness softens, the room is hushed. It's hard to see your way out.

Exits: north (Hall of Time) or east (Luminous Gardens)

* * *

>e
You're going to a VISITED room.

You are in Luminous Gardens
The number of viable directions is 2.

Luminous Gardens
Mushrooms the size of trees, glowing, are scattered among winding paths. Tiny lightning bugs flit between snow-pale cave blossoms.

Exits: south (Cavern of the Lake of Tears) or west (Den of Darkness)

>w
You're going to a VISITED room.

You are in Den of Darkness
The number of viable directions is 2.

Den of Darkness
The darkness softens, the room is hushed. It's hard to see your way out.

Exits: north (Hall of Time) or east (Luminous Gardens)

>n
You're going to a VISITED room.

You are in the Hall of Time
The number of viable directions is 2.

Hall of Time
A long, narrow hall, flickering with light from magefire sconces. The painted walls show the progression of time through planets and stars, sun and moons.

You can see a glowering elf here.

Exits: north (Uncanny Lair) or south (Den of Darkness)

>n
You're going to a VISITED room.

You are in Uncanny Lair
The number of viable directions is 2.

Uncanny Lair
Oddly shaped bones are strewn about this rough cave. Some creature made a nest in one corner out of shredded fungus.

Exits: north (Jewelled Forest) or south (Hall of Time)

>n
You're going to a VISITED room.

You are in Jewelled Forest
The number of viable directions is 2.

Jewelled Forest
Marvellous columns march down the length of this immense cave. Jewel-like lights shine from deep within.

Exits: south (Uncanny Lair) or west (Cavern of the Lake of Tears)

>s
You're going to a VISITED room.

You are in Uncanny Lair
The number of viable directions is 2.

Uncanny Lair
Oddly shaped bones are strewn about this rough cave. Some creature made a nest in one corner out of shredded fungus.

Exits: north (Jewelled Forest) or south (Hall of Time)

>s
You're going to a VISITED room.

You are in the Hall of Time
The number of viable directions is 2.

Hall of Time
A long, narrow hall, flickering with light from magefire sconces. The painted walls show the progression of time through planets and stars, sun and moons.

You can see a glowering elf here.

Exits: north (Uncanny Lair) or south (Den of Darkness)

* * *

>e
The number of viable directions is 1.
removing west because you just came from there 

Disturbing Hallway
The angles here, the colors, the feel of the air -- just wrong. Horribly wrong.

Exits: east (Webby Corridor) or west (Dungeon Entrance)

>e
The number of viable directions is 1.
removing west because you just came from there 

Webby Corridor
Dusty ropes of thick spiderweb festoon the walls.

You can see a soot sprite here.

Exits: north (Chamber of Lights) or west (Disturbing Hallway)

>peck sprite
You viciously peck the soot sprite, causing 5 points of damage!
You viciously peck the soot sprite, causing 5 points of damage!

The soot sprite leaps back in shock.
"I went to Monster Polytechnic for this?" it yells.
The soot sprite drags itself off into the darkness.

Exits: north (Chamber of Lights) or west (Disturbing Hallway)

[Your score has just gone up by one point.]

>n
The number of viable directions is 1.
removing south because you just came from there 

Chamber of Lights
An uncanny mottled glow emanates from the walls of this high-ceilinged cavern.

Exits: south (Webby Corridor) or down (Evil Archives)

>d
The number of viable directions is 1.

Evil Archives
Row upon row of moldering tomes, dust, and a sense of forboding fill this underground library.

You can see an iridium bat here.

Exits: west (Glittering Shrine) or up (Chamber of Lights)

>peck bat
You viciously peck the iridium bat, causing 9 points of damage!
You viciously peck the iridium bat, causing 3 points of damage!

The iridium bat attacks you, causing 5 points of damage!

Exits: west (Glittering Shrine) or up (Chamber of Lights)

>peck bat
You viciously peck the iridium bat, causing 5 points of damage!

The iridium bat leaps back in shock.
"That's it, I quit!" it whines, cringing.
The iridium bat drags itself off into the darkness.

Exits: west (Glittering Shrine) or up (Chamber of Lights)

[Your score has just gone up by one point.]

>w
The number of viable directions is 1.
removing east because you just came from there 

Glittering Shrine
Flecks of shining mica gleam from granite walls.

You can see an obsidian altar here.

Exits: south (Rockslide Cavern) or east (Evil Archives)

>s
The number of viable directions is 1.
removing north because you just came from there 

Rockslide Cavern
Boulders have tumbled down on one side of this cave. It's a tight squeeze to get by them.

You can see a vial of coffee and a cave snake here.

Exits: north (Glittering Shrine) or west (Luminous Gardens)

>take vial
Taken.

Exits: north (Glittering Shrine) or west (Luminous Gardens)

>drink vial
You feel mighty!

Exits: north (Glittering Shrine) or west (Luminous Gardens)

>stats
Strength: 6   Ferocity: 2   HP: 5/10 

Exits: north (Glittering Shrine) or west (Luminous Gardens)

>peck snake
You viciously peck the cave snake, causing 7 points of damage!
You viciously peck the cave snake, causing 8 points of damage!

The cave snake trips and falls.
"Oooh, that smarts," it shrieks, scuttling away.
The cave snake drags itself off into the darkness.

Exits: north (Glittering Shrine) or west (Luminous Gardens)

[Your score has just gone up by one point.]

* * *

>e
The number of viable directions is 1.
removing west because you just came from there 

Disturbing Hallway
The angles here, the colors, the feel of the air -- just wrong. Horribly wrong.

Exits: east (Webby Corridor) or west (Dungeon Entrance)

>peck mummy
You viciously peck the lumbering mummy, causing 4 points of damage!
You viciously peck the lumbering mummy, causing 6 points of damage!

The lumbering mummy attacks you, causing 4 points of damage!

Exits: east (Uncanny Lair) or west (Dungeon Entrance)

>peck mummy
You viciously peck the lumbering mummy, causing 3 points of damage!
You viciously peck the lumbering mummy, causing 7 points of damage!

The lumbering mummy leaps back in shock.
"Scare the adventurers, they said, it's easy, they said," it yells.
The lumbering mummy drags itself off into the darkness.

Exits: east (Uncanny Lair) or west (Dungeon Entrance)

>e
Unvisted: Jewelled Forest, Cavern of the Lake of Tears, Shorehaven, Evil Archives, Librarian's Lair, Glittering Shrine, Vault of Secrets, Webby Corridor, Chamber of Lights, Disturbing Hallway, Waterfall Cave, Marble Halls, Rockslide Cavern, Uncanny Lair, Luminous Gardens, Nasty Passage, Chilly Mausoleum, Hall of Time and Vault of Vastness.
Unpicked: Jewelled Forest, Evil Archives, Glittering Shrine, Webby Corridor, Chamber of Lights, Disturbing Hallway, Waterfall Cave, Marble Halls, Rockslide Cavern, Luminous Gardens, Nasty Passage, Chilly Mausoleum and Hall of Time.
~~~~ next room will be Hall of Time
available directions: north, south, east, west and down
removing west because you just came from there 
available directions: north, south, east and down
~~~~ next direction will be south

Uncanny Lair
Oddly shaped bones are strewn about this rough cave. Some creature made a nest in one corner out of shredded fungus.

Exits: south (Hall of Time) or west (Den of Darkness)

>s
Unvisted: Jewelled Forest, Cavern of the Lake of Tears, Shorehaven, Evil Archives, Librarian's Lair, Glittering Shrine, Vault of Secrets, Webby Corridor, Chamber of Lights, Disturbing Hallway, Waterfall Cave, Marble Halls, Rockslide Cavern, Luminous Gardens, Nasty Passage, Chilly Mausoleum, Hall of Time and Vault of Vastness.
Unpicked: Jewelled Forest, Evil Archives, Glittering Shrine, Webby Corridor, Chamber of Lights, Disturbing Hallway, Waterfall Cave, Marble Halls, Rockslide Cavern, Luminous Gardens, Nasty Passage and Chilly Mausoleum.
~~~~ next room will be Luminous Gardens
available directions: north, south, east, west and down
removing north because you just came from there 
available directions: south, east, west and down
~~~~ next direction will be west

Hall of Time
A long, narrow hall, flickering with light from magefire sconces. The painted walls show the progression of time through planets and stars, sun and moons.

You can see a spider here.

Exits: north (Uncanny Lair) or west (Luminous Gardens)

>peck spider
You viciously peck the spider, causing 5 points of damage!
You viciously peck the spider, causing 4 points of damage!

The spider attacks you, causing 3 points of damage!

Exits: north (Uncanny Lair) or west (Luminous Gardens)

>peck spider
You viciously peck the spider, causing 10 points of damage!

The spider trips and falls.
"That's it, I quit!" it shrieks.
The spider drags itself off into the darkness.

Exits: north (Uncanny Lair) or west (Luminous Gardens)

>l
Hall of Time
A long, narrow hall, flickering with light from magefire sconces. The painted walls show the progression of time through planets and stars, sun and moons.

Exits: north (Uncanny Lair) or west (Luminous Gardens)

>w
Unvisted: Jewelled Forest, Cavern of the Lake of Tears, Shorehaven, Evil Archives, Librarian's Lair, Glittering Shrine, Vault of Secrets, Webby Corridor, Chamber of Lights, Disturbing Hallway, Waterfall Cave, Marble Halls, Rockslide Cavern, Luminous Gardens, Nasty Passage, Chilly Mausoleum and Vault of Vastness.
Unpicked: Jewelled Forest, Evil Archives, Glittering Shrine, Webby Corridor, Chamber of Lights, Disturbing Hallway, Waterfall Cave, Marble Halls, Rockslide Cavern, Nasty Passage and Chilly Mausoleum.
~~~~ next room will be Webby Corridor
available directions: north, south, east, west and down
removing east because you just came from there 
available directions: north, south, west and down
~~~~ next direction will be south

Luminous Gardens
Mushrooms the size of trees, glowing, are scattered among winding paths. Tiny lightning bugs flit between snow-pale cave blossoms.

Exits: south (Webby Corridor) or east (Hall of Time)

>s
Unvisted: Jewelled Forest, Cavern of the Lake of Tears, Shorehaven, Evil Archives, Librarian's Lair, Glittering Shrine, Vault of Secrets, Webby Corridor, Chamber of Lights, Disturbing Hallway, Waterfall Cave, Marble Halls, Rockslide Cavern, Nasty Passage, Chilly Mausoleum and Vault of Vastness.
Unpicked: Jewelled Forest, Evil Archives, Glittering Shrine, Chamber of Lights, Disturbing Hallway, Waterfall Cave, Marble Halls, Rockslide Cavern, Nasty Passage and Chilly Mausoleum.
~~~~ next room will be Chamber of Lights
available directions: north, south, east, west and down
removing north because you just came from there 
available directions: south, east, west and down
~~~~ next direction will be east

Webby Corridor
Dusty ropes of thick spiderweb festoon the walls.

You can see a soot sprite here.

Exits: north (Luminous Gardens) or east (Chamber of Lights)

>peck sprite
You viciously peck the soot sprite, causing 4 points of damage!
You viciously peck the soot sprite, causing 10 points of damage!

The soot sprite falls over, gasping in pain.
"Scare the adventurers, they said, it's easy, they said," it shrieks.
The soot sprite drags itself off into the darkness.

Exits: north (Luminous Gardens) or east (Chamber of Lights)

>e
Unvisted: Jewelled Forest, Cavern of the Lake of Tears, Shorehaven, Evil Archives, Librarian's Lair, Glittering Shrine, Vault of Secrets, Chamber of Lights, Disturbing Hallway, Waterfall Cave, Marble Halls, Rockslide Cavern, Nasty Passage, Chilly Mausoleum and Vault of Vastness.
Unpicked: Jewelled Forest, Evil Archives, Glittering Shrine, Disturbing Hallway, Waterfall Cave, Marble Halls, Rockslide Cavern, Nasty Passage and Chilly Mausoleum.
~~~~ next room will be Chilly Mausoleum
available directions: north, south, east, west and down
removing west because you just came from there 
available directions: north, south, east and down
~~~~ next direction will be down

Chamber of Lights
An uncanny mottled glow emanates from the walls of this high-ceilinged cavern.

You can see a cave snake here.

Exits: west (Webby Corridor) or down (Chilly Mausoleum)

>peck snake
You viciously peck the cave snake, causing 10 points of damage!
You viciously peck the cave snake, causing 8 points of damage!

The cave snake leaps back in shock.
"This isn't how things are supposed to go!" it yelps.
The cave snake drags itself off into the darkness.

Exits: west (Webby Corridor) or down (Chilly Mausoleum)

>d
Unvisted: Jewelled Forest, Cavern of the Lake of Tears, Shorehaven, Evil Archives, Librarian's Lair, Glittering Shrine, Vault of Secrets, Disturbing Hallway, Waterfall Cave, Marble Halls, Rockslide Cavern, Nasty Passage, Chilly Mausoleum and Vault of Vastness.
Unpicked: Jewelled Forest, Evil Archives, Glittering Shrine, Disturbing Hallway, Waterfall Cave, Marble Halls, Rockslide Cavern and Nasty Passage.
~~~~ next room will be Rockslide Cavern
available directions: north, south, east, west and down
available directions: north, south, east, west and down
~~~~ next direction will be west

Chilly Mausoleum
Cold seeps into your bones. Faceless tombs loom overhead.

Exits: west (Rockslide Cavern) or up (Chamber of Lights)

>w
Unvisted: Jewelled Forest, Cavern of the Lake of Tears, Shorehaven, Evil Archives, Librarian's Lair, Glittering Shrine, Vault of Secrets, Disturbing Hallway, Waterfall Cave, Marble Halls, Rockslide Cavern, Nasty Passage and Vault of Vastness.
Unpicked: Jewelled Forest, Evil Archives, Glittering Shrine, Disturbing Hallway, Waterfall Cave, Marble Halls and Nasty Passage.
~~~~ next room will be Nasty Passage
available directions: north, south, east, west and down
removing east because you just came from there 
available directions: north, south, west and down
~~~~ next direction will be down

Rockslide Cavern
Boulders have tumbled down on one side of this cave. It's a tight squeeze to get by them.

Exits: east (Chilly Mausoleum) or down (Nasty Passage)

>d
Unvisted: Jewelled Forest, Cavern of the Lake of Tears, Shorehaven, Evil Archives, Librarian's Lair, Glittering Shrine, Vault of Secrets, Disturbing Hallway, Waterfall Cave, Marble Halls, Nasty Passage and Vault of Vastness.
Unpicked: Jewelled Forest, Evil Archives, Glittering Shrine, Disturbing Hallway, Waterfall Cave and Marble Halls.
~~~~ next room will be Marble Halls
available directions: north, south, east, west and down
available directions: north, south, east, west and down
~~~~ next direction will be down

Nasty Passage
A tight squeeze between damp and slimy boulders. There is blood on the ground.

You can see a glowering elf here.

Exits: up (Rockslide Cavern) or down (Marble Halls)

>d
Unvisted: Jewelled Forest, Cavern of the Lake of Tears, Shorehaven, Evil Archives, Librarian's Lair, Glittering Shrine, Vault of Secrets, Disturbing Hallway, Waterfall Cave, Marble Halls and Vault of Vastness.
Unpicked: Jewelled Forest, Evil Archives, Glittering Shrine, Disturbing Hallway and Waterfall Cave.
~~~~ next room will be Glittering Shrine
available directions: north, south, east, west and down
available directions: north, south, east, west and down
~~~~ next direction will be west

Marble Halls
White flowstone gleams in thick curtains on the walls of this magnificent hall.

Exits: west (Glittering Shrine) or up (Nasty Passage)

>w
Unvisted: Jewelled Forest, Cavern of the Lake of Tears, Shorehaven, Evil Archives, Librarian's Lair, Glittering Shrine, Vault of Secrets, Disturbing Hallway, Waterfall Cave and Vault of Vastness.
Unpicked: Jewelled Forest, Evil Archives, Disturbing Hallway and Waterfall Cave.
~~~~ next room will be Waterfall Cave
available directions: north, south, east, west and down
removing east because you just came from there 
available directions: north, south, west and down
~~~~ next direction will be down

Glittering Shrine
Flecks of shining mica gleam from granite walls.

You can see an obsidian altar here.

Exits: east (Marble Halls) or down (Waterfall Cave)

>x altar
A slab of black glass forms an altar along one wall. An inscription runs along its rim.

Exits: east (Marble Halls) or down (Waterfall Cave)

>x inscription
It says, in shimmering black letters, "Sphinx of black quartz, judge my vow."

Exits: east (Marble Halls) or down (Waterfall Cave)

>d
Unvisted: Jewelled Forest, Cavern of the Lake of Tears, Shorehaven, Evil Archives, Librarian's Lair, Vault of Secrets, Disturbing Hallway, Waterfall Cave and Vault of Vastness.
Unpicked: Jewelled Forest, Evil Archives and Disturbing Hallway.
~~~~ next room will be Disturbing Hallway
available directions: north, south, east, west and down
available directions: north, south, east, west and down
~~~~ next direction will be south

Waterfall Cave
Water pours down from high above, catching on stalactites and glinting in the eerie glow from the walls. A little pool lies underneath.

You can see an iridium bat here.

Exits: south (Disturbing Hallway) or up (Glittering Shrine)

>peck bat
You viciously peck the iridium bat, causing 9 points of damage!
You viciously peck the iridium bat, causing 4 points of damage!

The iridium bat attacks you, causing 5 points of damage!

You swoon.
The world shimmers and whirls.
You wake up nestled into a hollow of warm sand.
You feel completely healed after your nap.

Shorehaven
A peaceful, secluded little beach, just the right size for a dungeon-going goose. A good place to tuck your head under your wing for a short nap.

Exits: east (Cavern of the Lake of Tears)

>e
Unvisted: Jewelled Forest, Cavern of the Lake of Tears, Evil Archives, Librarian's Lair, Vault of Secrets, Disturbing Hallway and Vault of Vastness.
Unpicked: Jewelled Forest, Evil Archives and Disturbing Hallway.
~~~~ next room will be Disturbing Hallway
available directions: north, south, east, west and down
removing east because you just came from there 
available directions: north, south, west and down
~~~~ next direction will be west

Cavern of the Lake of Tears
A still, deep lake stretches into the distance. It's vast. You can't see the other side.

Exits: east (Jewelled Forest) or west (Disturbing Hallway)

>e
Unvisted: Jewelled Forest, Evil Archives, Librarian's Lair, Vault of Secrets, Disturbing Hallway and Vault of Vastness.
Unpicked: Evil Archives and Disturbing Hallway.
~~~~ next room will be Evil Archives
available directions: north, south, east, west and down
removing west because you just came from there 
available directions: north, south, east and down
~~~~ next direction will be north

Jewelled Forest
Marvellous columns march down the length of this immense cavern. Jewel-like lights shine from deep within.

Exits: north (Evil Archives) or west (Cavern of the Lake of Tears)

>n
Unvisted: Evil Archives, Librarian's Lair, Vault of Secrets, Disturbing Hallway and Vault of Vastness.
Unpicked: Disturbing Hallway.
~~~~ next room will be Disturbing Hallway
available directions: north, south, east, west and down
removing south because you just came from there 
available directions: north, east, west and down
~~~~ next direction will be north

Evil Archives
Row upon row of moldering tomes, dust, and a sense of forboding fill this underground library.

Exits: north (Disturbing Hallway) or south (Jewelled Forest)

>n
Unvisted: Librarian's Lair, Vault of Secrets, Disturbing Hallway and Vault of Vastness.
Unpicked: nothing.

Exits: north (Waterfall Cave) or south (Evil Archives) or east (Cavern of the Lake of Tears)

* * *

>e
The number of viable directions is 1.
removing west because you just came from there 

Disturbing Hallway
The angles here, the colors, the feel of the air -- just wrong. Horribly wrong.

Exits: east (Webby Corridor) or west (Dungeon Entrance)

>s
Waterfall Cave
Water pours down from high above, catching on stalactites and glinting in the eerie glow from the walls. A little pool lies underneath.

You can see a lumbering mummy here.

Exits: north (Chilly Mausoleum) or west (Rockslide Cavern)

>peck mummy
You viciously peck the lumbering mummy, causing 3 points of damage!
You viciously peck the lumbering mummy, causing 3 points of damage!

The lumbering mummy attacks you, causing 4 points of damage!

Exits: north (Chilly Mausoleum) or west (Rockslide Cavern)

>stats
Strength: 3   Ferocity: 2   HP: 6/10 

Exits: north (Chilly Mausoleum) or west (Rockslide Cavern)

>i
You are carrying nothing.

Exits: north (Chilly Mausoleum) or west (Rockslide Cavern)

* * *

>peck rat
You viciously peck the giant rat, causing 3 points of damage!
You viciously peck the giant rat, causing 3 points of damage!

The giant rat trips and falls.
"This isn't how things are supposed to go!" it shrieks.
The giant rat drags itself off into the darkness.

Exits: down (Rockslide Cavern)

[Your score has just gone up by one point.]

>n
The number of viable directions is 1.
removing south because you just came from there 

Waterfall Cave
Water pours down from high above, catching on stalactites and glinting in the eerie glow from the walls. A little pool lies underneath.

Exits: north (Marble Halls) or south (Dungeon Entrance)

>d
Hall of Time
A long, narrow hall, flickering with light from magefire sconces. The painted walls show the progression of time through planets and stars, sun and moons.

You can see a soot sprite here.

Exits: north (Uncanny Lair) or up (Waterfall Cave)

>peck sprite
You viciously peck the soot sprite, causing 4 points of damage!
You viciously peck the soot sprite, causing 7 points of damage!

The soot sprite trips and falls.
.
"Ouch! I'm out of here!" it shrieks.
The soot sprite drags itself off into the darkness.

Exits: north (Uncanny Lair) or up (Waterfall Cave)

* * *

>n
The number of viable directions is 1.
removing south because you just came from there 

Waterfall Cave
Water pours down from high above, catching on stalactites and glinting in the eerie glow from the walls. A little pool lies underneath.

Exits: north (Marble Halls) or south (Dungeon Entrance)

>e
Hall of Time
A long, narrow hall, flickering with light from magefire sconces. The painted walls show the progression of time through planets and stars, sun and moons.

Exits: north (Chamber of Lights) or west (Luminous Gardens)

>n
Chamber of Lights
An uncanny mottled glow emanates from the walls of this high-ceilinged cavern.

Exits: south (Hall of Time) or down (Den of Darkness)

>d
Den of Darkness
The darkness softens, the room is hushed. It's hard to see your way out.

Exits: south (Webby Corridor) or up (Chamber of Lights)

>s
Webby Corridor
Dusty ropes of thick spiderweb festoon the walls.

Exits: north (Den of Darkness) or east (Waterfall Cave)

>e
Waterfall Cave
Water pours down from high above, catching on stalactites and glinting in the eerie glow from the walls. A little pool lies underneath.

Exits: east (Rockslide Cavern) or west (Webby Corridor)

>e
Rockslide Cavern
Boulders have tumbled down on one side of this cave. It's a tight squeeze to get by them.

Exits: north (Chilly Mausoleum) or west (Waterfall Cave)

>n
Chilly Mausoleum
Cold seeps into your bones. Faceless tombs loom overhead.

Exits: north (Marble Halls) or south (Rockslide Cavern)

>n
Marble Halls
White flowstone gleams in thick curtains on the walls of this magnificent hall.

Exits: south (Chilly Mausoleum) or east (Disturbing Hallway)

* * *

>n
The number of viable directions is 1.
removing south because you just came from there 

Waterfall Cave
Water pours down from high above, catching on stalactites and glinting in the eerie glow from the walls. A little pool lies underneath.

Exits: north (Marble Halls) or south (Dungeon Entrance)

>n
The number of viable directions is 1.
removing south because you just came from there 

Marble Halls
White flowstone gleams in thick curtains on the walls of this magnificent hall.

Exits: south (Waterfall Cave) or east (Den of Darkness)

>e
The number of viable directions is 1.
removing west because you just came from there 

Den of Darkness
The darkness softens, the room is hushed. It's hard to see your way out.

Exits: north (Disturbing Hallway) or west (Marble Halls)

>w
You're going to a VISITED room.

The number of viable directions is 2.

Marble Halls
White flowstone gleams in thick curtains on the walls of this magnificent hall.

Exits: south (Waterfall Cave) or east (Den of Darkness)

>e
You're going to a VISITED room.

The number of viable directions is 2.

Den of Darkness
The darkness softens, the room is hushed. It's hard to see your way out.

Exits: north (Disturbing Hallway) or west (Marble Halls)

>n
The number of viable directions is 1.
removing south because you just came from there 

Disturbing Hallway
The angles here, the colors, the feel of the air -- just wrong. Horribly wrong.

You can see a tentacled horror here.

Exits: south (Den of Darkness) or down (Luminous Gardens)

>peck horror
You viciously peck the tentacled horror, causing 3 points of damage!
You viciously peck the tentacled horror, causing 6 points of damage!

The tentacled horror attacks you, causing 6 points of damage!
The tentacled horror attacks you, causing 4 points of damage!

You swoon.
The world shimmers and whirls.
You wake up nestled into a hollow of warm sand.
You feel completely healed after your nap.

Shorehaven
A peaceful, secluded little beach, just the right size for a dungeon-going goose. A good place to tuck your head under your wing for a short nap. Or you can swim out into the lake.

Exits:

* * *

>peck rat
You viciously peck the giant rat, causing 3 points of damage!
You viciously peck the giant rat, causing 3 points of damage!

The giant rat trips and falls.
"This isn't how things are supposed to go!" it shrieks.
The giant rat drags itself off into the darkness.

Exits: down (Rockslide Cavern)

[Your score has just gone up by one point.]

>peck mummy
You viciously peck the lumbering mummy, causing 10 points of damage!
You viciously peck the lumbering mummy, causing 6 points of damage!

The lumbering mummy falls over, gasping in pain.
"The dispatcher didn't warn us! This is too much!" it whines, cringing.
The lumbering mummy drags itself off into the darkness.

Exits: east (Uncanny Lair)

>e
You are in Uncanny Lair
The number of viable directions is 1.
You are in Uncanny Lair for the FIRST time
~~~~ next room will be Nasty Passage
available directions: north, south, east, west and down
removing west because you just came from there 
~~~~ next direction will be east

Uncanny Lair
Oddly shaped bones are strewn about this rough cave. Some creature made a nest in one corner out of shredded fungus.

You can see a cave snake here.

Exits: east (Nasty Passage) or west (Dungeon Entrance)

>peck snake
You viciously peck the cave snake, causing 4 points of damage!
You viciously peck the cave snake, causing 3 points of damage!

The cave snake attacks you, causing 2 points of damage!

Exits: east (Nasty Passage) or west (Dungeon Entrance)

>peck snake
You viciously peck the cave snake, causing 10 points of damage!

The cave snake trips and falls.
"Ouch! I'm out of here!" it shrieks, scuttling away.
The cave snake drags itself off into the darkness.

Exits: east (Nasty Passage) or west (Dungeon Entrance)

>e
You are in Nasty Passage
The number of viable directions is 1.
You are in Nasty Passage for the FIRST time
~~~~ next room will be Den of Darkness
available directions: north, south, east, west and down
removing west because you just came from there 
~~~~ next direction will be south

Nasty Passage
A tight squeeze between damp and slimy boulders. There is blood on the ground.

Exits: south (Den of Darkness) or west (Uncanny Lair)

>s
You are in Den of Darkness
The number of viable directions is 1.
You are in Den of Darkness for the FIRST time
~~~~ next room will be Evil Archives
available directions: north, south, east, west and down
removing north because you just came from there 
~~~~ next direction will be down

Den of Darkness
The darkness softens, the room is hushed. It's hard to see your way out.

You can see a confused adventurer here.

Exits: north (Nasty Passage) or down (Evil Archives)

>peck adventurer
You viciously peck the confused adventurer, causing 5 points of damage!
You viciously peck the confused adventurer, causing 10 points of damage!

The confused adventurer attacks you, causing 2 points of damage!

Exits: north (Nasty Passage) or down (Evil Archives)

>peck adventurer
You viciously peck the confused adventurer, causing 9 points of damage!
You viciously peck the confused adventurer, causing 5 points of damage!

The confused adventurer leaps back in shock.
"Oooh, that smarts," it shrieks, scuttling away.
The confused adventurer drags itself off into the darkness.

Exits: north (Nasty Passage) or down (Evil Archives)

>d
You are in Evil Archives
The number of viable directions is 1.
You are in Evil Archives for the FIRST time
~~~~ next room will be Luminous Gardens
available directions: north, south, east, west and down
~~~~ next direction will be down

Evil Archives
Row upon row of moldering tomes, dust, and a sense of forboding fill this underground library.

Exits: up (Den of Darkness) or down (Luminous Gardens)

>d
You are in Luminous Gardens
The number of viable directions is 1.
You are in Luminous Gardens for the FIRST time
~~~~ next room will be Chamber of Lights
available directions: north, south, east, west and down
~~~~ next direction will be north

Luminous Gardens
Mushrooms the size of trees, glowing, are scattered among winding paths. Tiny lightning bugs flit between snow-pale cave blossoms.

Exits: north (Chamber of Lights) or up (Evil Archives)

>n
You are in Chamber of Lights
The number of viable directions is 1.
You are in Chamber of Lights for the FIRST time
~~~~ next room will be Rockslide Cavern
available directions: north, south, east, west and down
removing south because you just came from there 
~~~~ next direction will be east

Chamber of Lights
An uncanny mottled glow emanates from the walls of this high-ceilinged cavern.

Exits: south (Luminous Gardens) or east (Rockslide Cavern)

>e
You are in Rockslide Cavern
The number of viable directions is 1.
You are in Rockslide Cavern for the FIRST time
~~~~ next room will be Chilly Mausoleum
available directions: north, south, east, west and down
removing west because you just came from there 
~~~~ next direction will be down

Rockslide Cavern
Boulders have tumbled down on one side of this cave. It's a tight squeeze to get by them.

Exits: west (Chamber of Lights) or down (Chilly Mausoleum)

>d
You are in Chilly Mausoleum
The number of viable directions is 1.
You are in Chilly Mausoleum for the FIRST time
~~~~ next room will be Glittering Shrine
available directions: north, south, east, west and down
~~~~ next direction will be north

Chilly Mausoleum
Cold seeps into your bones. Faceless tombs loom overhead.

Exits: north (Glittering Shrine) or up (Rockslide Cavern)

>n
You are in Glittering Shrine
The number of viable directions is 1.
You are in Glittering Shrine for the FIRST time
~~~~ next room will be Webby Corridor
available directions: north, south, east, west and down
removing south because you just came from there 
~~~~ next direction will be down

Glittering Shrine
Flecks of shining mica gleam from granite walls.

You can see a wispy ghost and an obsidian altar here.

Exits: south (Chilly Mausoleum) or down (Webby Corridor)

>peck ghost
You viciously peck the wispy ghost, causing 10 points of damage!
You viciously peck the wispy ghost, causing 4 points of damage!

The wispy ghost falls over, gasping in pain.
"That's it, I quit!" it shrieks, scuttling away.
The wispy ghost drags itself off into the darkness.

Exits: south (Chilly Mausoleum) or down (Webby Corridor)

>d
You are in Webby Corridor
The number of viable directions is 1.
You are in Webby Corridor for the FIRST time
~~~~ next room will be Hall of Time
available directions: north, south, east, west and down
~~~~ next direction will be north

Webby Corridor
Dusty ropes of thick spiderweb festoon the walls.

You can see a tentacled horror here.

Exits: north (Hall of Time) or up (Glittering Shrine)

>n
You are in the Hall of Time
The number of viable directions is 1.
You are in the Hall of Time for the FIRST time
~~~~ next room will be Marble Halls
available directions: north, south, east, west and down
removing south because you just came from there 
~~~~ next direction will be east

Hall of Time
A long, narrow hall, flickering with light from magefire sconces. The painted walls show the progression of time through planets and stars, sun and moons.

Exits: south (Webby Corridor) or east (Marble Halls)

>e
You are in Marble Halls
The number of viable directions is 1.
You are in Marble Halls for the FIRST time
~~~~ next room will be Waterfall Cave
available directions: north, south, east, west and down
removing west because you just came from there 
~~~~ next direction will be north

Marble Halls
White flowstone gleams in thick curtains on the walls of this magnificent hall.

You can see an iridium bat here.

Exits: north (Waterfall Cave) or west (Hall of Time)

>n
You are in Waterfall Cave
The number of viable directions is 1.
You are in Waterfall Cave for the FIRST time
~~~~ next room will be Jewelled Forest
available directions: north, south, east, west and down
removing south because you just came from there 
~~~~ next direction will be north

Waterfall Cave
Water pours down from high above, catching on stalactites and glinting in the eerie glow from the walls. A little pool lies underneath.

Exits: north (Jewelled Forest) or south (Marble Halls)

>n
You are in Jewelled Forest
The number of viable directions is 2.

Jewelled Forest
Marvellous columns march down the length of this immense cavern. Jewel-like lights shine from deep within.

Exits: south (Waterfall Cave) or west (Cavern of the Lake of Tears)

>w
You are in Cavern of the Lake of Tears
The number of viable directions is 1.

Cavern of the Lake of Tears
A still, deep lake stretches into the distance. It's vast. You can't see the other side.

Exits: east (Jewelled Forest)

>swim
The water feels great!
Ominous, like a grim battleship, you glide across the crystal waters.
You notice a little beach to the west.

Exits: east (Jewelled Forest) or west (Shorehaven)

>w
You get out of the water.
You are in Shorehaven
The number of viable directions is 1.

Shorehaven
A peaceful, secluded little beach, just the right size for a dungeon-going goose. A good place to tuck your head under your wing for a short nap.

Exits: east (Cavern of the Lake of Tears)

>e
You're going to a VISITED room.

You are in Cavern of the Lake of Tears
The number of viable directions is 1.

Cavern of the Lake of Tears
A still, deep lake stretches into the distance. It's vast. You can't see the other side.

Exits: east (Jewelled Forest)

>e
You're going to a VISITED room.

You are in Jewelled Forest
The number of viable directions is 2.

Jewelled Forest
Marvellous columns march down the length of this immense cavern. Jewel-like lights shine from deep within.

Exits: south (Waterfall Cave) or west (Cavern of the Lake of Tears)

>s
You're going to a VISITED room.

You are in Waterfall Cave
The number of viable directions is 2.

Waterfall Cave
Water pours down from high above, catching on stalactites and glinting in the eerie glow from the walls. A little pool lies underneath.

Exits: north (Jewelled Forest) or south (Marble Halls)

>s
You're going to a VISITED room.

You are in Marble Halls
The number of viable directions is 2.

Marble Halls
White flowstone gleams in thick curtains on the walls of this magnificent hall.

You can see an iridium bat here.

Exits: north (Waterfall Cave) or west (Hall of Time)

>w
You're going to a VISITED room.

You are in the Hall of Time
The number of viable directions is 2.

Hall of Time
A long, narrow hall, flickering with light from magefire sconces. The painted walls show the progression of time through planets and stars, sun and moons.

Exits: south (Webby Corridor) or east (Marble Halls)

>s
You're going to a VISITED room.

You are in Webby Corridor
The number of viable directions is 2.

Webby Corridor
Dusty ropes of thick spiderweb festoon the walls.

You can see a tentacled horror here.

Exits: north (Hall of Time) or up (Glittering Shrine)

>n
You're going to a VISITED room.

You are in the Hall of Time
The number of viable directions is 2.

Hall of Time
A long, narrow hall, flickering with light from magefire sconces. The painted walls show the progression of time through planets and stars, sun and moons.

Exits: south (Webby Corridor) or east (Marble Halls)

>e
You're going to a VISITED room.

You are in Marble Halls
The number of viable directions is 2.

Marble Halls
White flowstone gleams in thick curtains on the walls of this magnificent hall.

You can see an iridium bat here.

Exits: north (Waterfall Cave) or west (Hall of Time)

>n
You're going to a VISITED room.

You are in Waterfall Cave
The number of viable directions is 2.

Waterfall Cave
Water pours down from high above, catching on stalactites and glinting in the eerie glow from the walls. A little pool lies underneath.

Exits: north (Jewelled Forest) or south (Marble Halls)

>n
You're going to a VISITED room.

You are in Jewelled Forest
The number of viable directions is 2.

Jewelled Forest
Marvellous columns march down the length of this immense cavern. Jewel-like lights shine from deep within.

Exits: south (Waterfall Cave) or west (Cavern of the Lake of Tears)

>w
You're going to a VISITED room.

You are in Cavern of the Lake of Tears
The number of viable directions is 1.

Cavern of the Lake of Tears
A still, deep lake stretches into the distance. It's vast. You can't see the other side.

Exits: east (Jewelled Forest)

>e
You're going to a VISITED room.

You are in Jewelled Forest
The number of viable directions is 2.

Jewelled Forest
Marvellous columns march down the length of this immense cavern. Jewel-like lights shine from deep within.

Exits: south (Waterfall Cave) or west (Cavern of the Lake of Tears)

* * *

>peck rat
You viciously peck the giant rat, causing 3 points of damage!
You viciously peck the giant rat, causing 3 points of damage!

The giant rat trips and falls.
"This isn't how things are supposed to go!" it shrieks.
The giant rat drags itself off into the darkness.

Exits: down (Rockslide Cavern)

[Your score has just gone up by one point.]

>peck rat
You attack the giant rat, causing 10 points of damage!

The giant rat falls over, gasping in pain. It drags itself off into the darkness.

Exits: down (Disturbing Hallway)

* * *

>peck rat
You viciously peck the giant rat, causing 3 points of damage!
You viciously peck the giant rat, causing 3 points of damage!

The giant rat trips and falls.
"This isn't how things are supposed to go!" it shrieks.
The giant rat drags itself off into the darkness.

Exits: down (Rockslide Cavern)

[Your score has just gone up by one point.]

>s
The number of viable directions is 1.
removing north because you just came from there 

Rockslide Cavern
Boulders have tumbled down on one side of this cave. It's a tight squeeze to get by them.

You can see a tentacled horror here.

Exits: north (Dungeon Entrance) or south (Waterfall Cave)

>d
Disturbing Hallway
The angles here, the colors, the feel of the air -- just wrong. Horribly wrong.

Exits: east (Webby Corridor) or up (Uncanny Lair)

>e
Webby Corridor
Dusty ropes of thick spiderweb festoon the walls.

Exits: east (Waterfall Cave) or west (Disturbing Hallway)

>e
Waterfall Cave
Water pours down from high above, catching on stalactites and glinting in the eerie glow from the walls. A little pool lies underneath.

You can see a soot sprite here.

Exits: north (Evil Archives) or west (Webby Corridor)

>peck sprite
You viciously peck the soot sprite, causing 5 points of damage!
You viciously peck the soot sprite, causing 8 points of damage!

The soot sprite leaps back in shock.
"Ow, that's going too far!" it shrieks.
The soot sprite drags itself off into the darkness.

Exits: north (Evil Archives) or west (Webby Corridor)

>n
Evil Archives
Row upon row of moldering tomes, dust, and a sense of forboding fill this underground library.

You can see a grumpy kobold here.

Exits: south (Waterfall Cave) or east (Jewelled Forest)

>kill kobold
You viciously peck the grumpy kobold, causing 9 points of damage!
You viciously peck the grumpy kobold, causing 6 points of damage!

The grumpy kobold attacks you, causing 1 points of damage!

Exits: south (Waterfall Cave) or east (Jewelled Forest)

>kill kobold
You viciously peck the grumpy kobold, causing 9 points of damage!

The grumpy kobold trips and falls.
"The dispatcher didn't warn us! This is too much!" it yelps.
The grumpy kobold drags itself off into the darkness.

Exits: south (Waterfall Cave) or east (Jewelled Forest)

>x self
You crane your long, graceful neck to look back. 
White, muscular, hefty, feathered. 
Yes, you're still a fabulous goose!

Exits: south (Waterfall Cave) or east (Jewelled Forest)

>stats
Strength: 3   Ferocity: 2   HP: 9/10 

Exits: south (Waterfall Cave) or east (Jewelled Forest)

>honk
HONK!!!!

A shower of dust cascades from above.

Exits: south (Waterfall Cave) or east (Jewelled Forest)

>flap
You flap your wings, menacing everything in the near vicinity.

Exits: south (Waterfall Cave) or east (Jewelled Forest)

* * *

>s
The number of viable directions is 1.
removing north because you just came from there 

Rockslide Cavern
Boulders have tumbled down on one side of this cave. It's a tight squeeze to get by them.

You can see a tentacled horror here.

Exits: north (Dungeon Entrance) or south (Waterfall Cave)

>peck horror
You viciously peck the tentacled horror, causing 9 points of damage!
You viciously peck the tentacled horror, causing 9 points of damage!

The tentacled horror attacks you, causing 5 points of damage!
The tentacled horror attacks you, causing 5 points of damage!

You swoon.
The world shimmers and whirls.
You wake up nestled into a hollow of warm sand.
You feel completely healed after your nap.

Shorehaven
A peaceful, secluded little beach, just the right size for a dungeon-going goose. A good place to tuck your head under your wing for a short nap. Or you can swim out into the lake.

Exits:

>l
Shorehaven
A peaceful, secluded little beach, just the right size for a dungeon-going goose. A good place to tuck your head under your wing for a short nap. Or you can swim out into the lake.

Exits:

>swim
The water feels great!
Ominous, like a grim battleship, you glide across the crystal waters.

Cavern of the Lake of Tears
A still, deep lake stretches into the distance. It's vast. You can't see the other side.

Exits:

>l
Cavern of the Lake of Tears
A still, deep lake stretches into the distance. It's vast. You can't see the other side.

Exits:

* * *

>s
The number of viable directions is 1.
removing north because you just came from there 

Rockslide Cavern
Boulders have tumbled down on one side of this cave. It's a tight squeeze to get by them.

You can see a tentacled horror here.

Exits: north (Dungeon Entrance) or south (Waterfall Cave)

>peck snack
You can't see any such thing.

>peck snake
You attack the cave snake, causing 7 points of damage!
You attack the cave snake, causing 3 points of damage!

The cave snake attacks you, causing 4 points of damage!

Exits: north (Dungeon Entrance) or down (Rockslide Cavern)

>peck snake
You attack the cave snake, causing 10 points of damage!

The cave snake falls over, gasping in pain.
"Mama always told me never to cross a dungeon picket line.", it yells.

It drags itself off into the darkness.

Exits: north (Dungeon Entrance) or down (Rockslide Cavern)

* * *

>s
The number of viable directions is 1.
removing north because you just came from there 

Rockslide Cavern
Boulders have tumbled down on one side of this cave. It's a tight squeeze to get by them.

You can see a tentacled horror here.

Exits: north (Dungeon Entrance) or south (Waterfall Cave)

>w
Disturbing Hallway
The angles here, the colors, the feel of the air -- just wrong. Horribly wrong.

You can see a lumbering mummy here.

Exits: east (Marble Halls) or down (Glittering Shrine)

>honk
HONK!!!!

Startled, a denizen of the dungeon looks up in alarm.

Exits: east (Marble Halls) or down (Glittering Shrine)

>l
Disturbing Hallway
The angles here, the colors, the feel of the air -- just wrong. Horribly wrong.

You can see a lumbering mummy here.

Exits: east (Marble Halls) or down (Glittering Shrine)

>d
Glittering Shrine
Flecks of shining mica gleam from granite walls.

You can see a gelatinous cube and an obsidian altar here.

Exits: north (Chilly Mausoleum) or up (Disturbing Hallway)

>honk
HONK!!!!

A creature nearby jumps in fear.

Exits: north (Chilly Mausoleum) or up (Disturbing Hallway)

>look altar
A slab of black glass forms an altar along one wall. An inscription runs along its rim.

Exits: north (Chilly Mausoleum) or up (Disturbing Hallway)

>look inscription
Sphinx of black quartz, judge my vow.

Exits: north (Chilly Mausoleum) or up (Disturbing Hallway)

* * *

>peck rat
You viciously peck the giant rat, causing 3 points of damage!
You viciously peck the giant rat, causing 3 points of damage!

The giant rat trips and falls.
"This isn't how things are supposed to go!" it shrieks.
The giant rat drags itself off into the darkness.

Exits: down (Rockslide Cavern)

[Your score has just gone up by one point.]

>w
The number of viable directions is 1.
removing east because you just came from there 

Chilly Mausoleum
Cold seeps into your bones. Faceless tombs loom overhead.

You can see a tentacled horror here.

Exits: south (Webby Corridor) or east (Dungeon Entrance)

>d
Unvisted: Jewelled Forest, Cavern of the Lake of Tears, Shorehaven, Evil Archives, Librarian's Lair, Glittering Shrine, Vault of Secrets, Webby Corridor, Chamber of Lights, Disturbing Hallway, Waterfall Cave, Marble Halls, Rockslide Cavern, Den of Darkness, Luminous Gardens, Nasty Passage, Chilly Mausoleum, Hall of Time and Vault of Vastness
.
You are in Marble Halls
The number of viable directions is 1.
You are in Marble Halls for the FIRST time
Unpicked: Jewelled Forest, Cavern of the Lake of Tears, Evil Archives, Glittering Shrine, Webby Corridor, Chamber of Lights, Disturbing Hallway, Waterfall Cave, Rockslide Cavern, Den of Darkness, Luminous Gardens, Nasty Passage, Chilly Mausoleum and Hall of Time.
~~~~ next room will be Chilly Mausoleum
available directions: north, south, east, west and down
available directions: north, south, east, west and down
~~~~ next direction will be south

Marble Halls
White flowstone gleams in thick curtains on the walls of this magnificent hall.

You can see a lumbering mummy here.

Exits: south (Chilly Mausoleum) or up (Uncanny Lair)

>peck mummy
You viciously peck the lumbering mummy, causing 4 points of damage!
You viciously peck the lumbering mummy, causing 3 points of damage!

The lumbering mummy attacks you, causing 4 points of damage!

Exits: south (Chilly Mausoleum) or up (Uncanny Lair)

>peck mummy
You viciously peck the lumbering mummy, causing 3 points of damage!
You viciously peck the lumbering mummy, causing 9 points of damage!

The lumbering mummy trips and falls.
"This isn't how things are supposed to go!" it yelps.
The lumbering mummy drags itself off into the darkness.

Exits: south (Chilly Mausoleum) or up (Uncanny Lair)

>s
Unvisted: Jewelled Forest, Cavern of the Lake of Tears, Shorehaven, Evil Archives, Librarian's Lair, Glittering Shrine, Vault of Secrets, Webby Corridor, Chamber of Lights, Disturbing Hallway, Waterfall Cave, Rockslide Cavern, Den of Darkness, Luminous Gardens, Nasty Passage, Chilly Mausoleum, Hall of Time and Vault of Vastness
.
You are in Chilly Mausoleum
The number of viable directions is 1.
You are in Chilly Mausoleum for the FIRST time
Unpicked: Jewelled Forest, Cavern of the Lake of Tears, Evil Archives, Glittering Shrine, Webby Corridor, Chamber of Lights, Disturbing Hallway, Waterfall Cave, Rockslide Cavern, Den of Darkness, Luminous Gardens, Nasty Passage and Hall of Time.
~~~~ next room will be Cavern of the Lake of Tears
available directions: north, south, east, west and down
removing north because you just came from there 
available directions: south, east, west and down
~~~~ next direction will be east

Chilly Mausoleum
Cold seeps into your bones. Faceless tombs loom overhead.

Exits: north (Marble Halls) or east (Cavern of the Lake of Tears)

>e
Unvisted: Jewelled Forest, Cavern of the Lake of Tears, Shorehaven, Evil Archives, Librarian's Lair, Glittering Shrine, Vault of Secrets, Webby Corridor, Chamber of Lights, Disturbing Hallway, Waterfall Cave, Rockslide Cavern, Den of Darkness, Luminous Gardens, Nasty Passage, Hall of Time and Vault of Vastness
.
You are in Cavern of the Lake of Tears
The number of viable directions is 2.

Cavern of the Lake of Tears
A still, deep lake stretches into the distance. It's vast. You can't see the other side.

Exits: east (Jewelled Forest) or west (Chilly Mausoleum)

>e
Unvisted: Jewelled Forest, Shorehaven, Evil Archives, Librarian's Lair, Glittering Shrine, Vault of Secrets, Webby Corridor, Chamber of Lights, Disturbing Hallway, Waterfall Cave, Rockslide Cavern, Den of Darkness, Luminous Gardens, Nasty Passage, Hall of Time and Vault of Vastness
.
You are in Jewelled Forest
The number of viable directions is 1.
You are in Jewelled Forest for the FIRST time
Unpicked: Cavern of the Lake of Tears, Evil Archives, Glittering Shrine, Webby Corridor, Chamber of Lights, Disturbing Hallway, Waterfall Cave, Rockslide Cavern, Den of Darkness, Luminous Gardens, Nasty Passage and Hall of Time.
~~~~ next room will be Hall of Time
available directions: north, south, east, west and down
removing west because you just came from there 
available directions: north, south, east and down
~~~~ next direction will be east

Jewelled Forest
Marvellous columns march down the length of this immense cave. Jewel-like lights shine from deep within.

You can see a cave snake here.

Exits: east (Hall of Time) or west (Cavern of the Lake of Tears)

>peck snake
You viciously peck the cave snake, causing 8 points of damage!
You viciously peck the cave snake, causing 7 points of damage!

The cave snake trips and falls.
"The dispatcher didn't warn us! This is too much!" it whines, cringing.
The cave snake drags itself off into the darkness.

Exits: east (Hall of Time) or west (Cavern of the Lake of Tears)

>e
Unvisted: Shorehaven, Evil Archives, Librarian's Lair, Glittering Shrine, Vault of Secrets, Webby Corridor, Chamber of Lights, Disturbing Hallway, Waterfall Cave, Rockslide Cavern, Den of Darkness, Luminous Gardens, Nasty Passage, Hall of Time and Vault of Vastness
.
You are in the Hall of Time
The number of viable directions is 1.
You are in the Hall of Time for the FIRST time
Unpicked: Cavern of the Lake of Tears, Evil Archives, Glittering Shrine, Webby Corridor, Chamber of Lights, Disturbing Hallway, Waterfall Cave, Rockslide Cavern, Den of Darkness, Luminous Gardens and Nasty Passage.
~~~~ next room will be Webby Corridor
available directions: north, south, east, west and down
removing west because you just came from there 
available directions: north, south, east and down
~~~~ next direction will be south

Hall of Time
A long, narrow hall, flickering with light from magefire sconces. The painted walls show the progression of time through planets and stars, sun and moons.

Exits: south (Webby Corridor) or west (Jewelled Forest)

>s
Unvisted: Shorehaven, Evil Archives, Librarian's Lair, Glittering Shrine, Vault of Secrets, Webby Corridor, Chamber of Lights, Disturbing Hallway, Waterfall Cave, Rockslide Cavern, Den of Darkness, Luminous Gardens, Nasty Passage and Vault of Vastness
.
You are in Webby Corridor
The number of viable directions is 1.
You are in Webby Corridor for the FIRST time
Unpicked: Cavern of the Lake of Tears, Evil Archives, Glittering Shrine, Chamber of Lights, Disturbing Hallway, Waterfall Cave, Rockslide Cavern, Den of Darkness, Luminous Gardens and Nasty Passage.
~~~~ next room will be Cavern of the Lake of Tears
available directions: north, south, east, west and down
removing north because you just came from there 
available directions: south, east, west and down
~~~~ next direction will be west

Webby Corridor
Dusty ropes of thick spiderweb festoon the walls.

Exits: north (Hall of Time) or west (Cavern of the Lake of Tears)

>w
You're going to a VISITED room.

Unvisted: Shorehaven, Evil Archives, Librarian's Lair, Glittering Shrine, Vault of Secrets, Chamber of Lights, Disturbing Hallway, Waterfall Cave, Rockslide Cavern, Den of Darkness, Luminous Gardens, Nasty Passage and Vault of Vastness
.
You are in Cavern of the Lake of Tears
The number of viable directions is 2.

Cavern of the Lake of Tears
A still, deep lake stretches into the distance. It's vast. You can't see the other side.

Exits: east (Webby Corridor) or west (Chilly Mausoleum)

>w
You're going to a VISITED room.

Unvisted: Shorehaven, Evil Archives, Librarian's Lair, Glittering Shrine, Vault of Secrets, Chamber of Lights, Disturbing Hallway, Waterfall Cave, Rockslide Cavern, Den of Darkness, Luminous Gardens, Nasty Passage and Vault of Vastness
.
You are in Chilly Mausoleum
The number of viable directions is 2.

Chilly Mausoleum
Cold seeps into your bones. Faceless tombs loom overhead.

Exits: north (Marble Halls) or east (Cavern of the Lake of Tears)

>n
You're going to a VISITED room.

Unvisted: Shorehaven, Evil Archives, Librarian's Lair, Glittering Shrine, Vault of Secrets, Chamber of Lights, Disturbing Hallway, Waterfall Cave, Rockslide Cavern, Den of Darkness, Luminous Gardens, Nasty Passage and Vault of Vastness
.
You are in Marble Halls
The number of viable directions is 2.

Marble Halls
White flowstone gleams in thick curtains on the walls of this magnificent hall.

Exits: south (Chilly Mausoleum) or up (Uncanny Lair)

>up
You're going to a VISITED room.

Unvisted: Shorehaven, Evil Archives, Librarian's Lair, Glittering Shrine, Vault of Secrets, Chamber of Lights, Disturbing Hallway, Waterfall Cave, Rockslide Cavern, Den of Darkness, Luminous Gardens, Nasty Passage and Vault of Vastness
.
You are in Uncanny Lair
The number of viable directions is 2.

Uncanny Lair
Oddly shaped bones are strewn about this rough cave. Some creature made a nest in one corner out of shredded fungus.

Exits: east (Dungeon Entrance) or down (Marble Halls)

>e
You're going to a VISITED room.

Unvisted: Shorehaven, Evil Archives, Librarian's Lair, Glittering Shrine, Vault of Secrets, Chamber of Lights, Disturbing Hallway, Waterfall Cave, Rockslide Cavern, Den of Darkness, Luminous Gardens, Nasty Passage and Vault of Vastness
.
You are in Dungeon Entrance
The number of viable directions is 1.

Dungeon Entrance
Stone walls, mildewed with glowing stuff, widen into a large bare room.

You can see a trophy case (empty) here.

Exits: west (Uncanny Lair)

>w
You're going to a VISITED room.

Unvisted: Shorehaven, Evil Archives, Librarian's Lair, Glittering Shrine, Vault of Secrets, Chamber of Lights, Disturbing Hallway, Waterfall Cave, Rockslide Cavern, Den of Darkness, Luminous Gardens, Nasty Passage and Vault of Vastness
.
You are in Uncanny Lair
The number of viable directions is 2.

Uncanny Lair
Oddly shaped bones are strewn about this rough cave. Some creature made a nest in one corner out of shredded fungus.

Exits: east (Dungeon Entrance) or down (Marble Halls)

>d
You're going to a VISITED room.

Unvisted: Shorehaven, Evil Archives, Librarian's Lair, Glittering Shrine, Vault of Secrets, Chamber of Lights, Disturbing Hallway, Waterfall Cave, Rockslide Cavern, Den of Darkness, Luminous Gardens, Nasty Passage and Vault of Vastness
.
You are in Marble Halls
The number of viable directions is 2.

Marble Halls
White flowstone gleams in thick curtains on the walls of this magnificent hall.

Exits: south (Chilly Mausoleum) or up (Uncanny Lair)

>kup
That's not a verb I recognise.

>up
You're going to a VISITED room.

Unvisted: Shorehaven, Evil Archives, Librarian's Lair, Glittering Shrine, Vault of Secrets, Chamber of Lights, Disturbing Hallway, Waterfall Cave, Rockslide Cavern, Den of Darkness, Luminous Gardens, Nasty Passage and Vault of Vastness
.
You are in Uncanny Lair
The number of viable directions is 2.

Uncanny Lair
Oddly shaped bones are strewn about this rough cave. Some creature made a nest in one corner out of shredded fungus.

Exits: east (Dungeon Entrance) or down (Marble Halls)

* * *

>d
You're going to a VISITED room.

Unvisted: Shorehaven, Evil Archives, Librarian's Lair, Glittering Shrine, Vault of Secrets, Chamber of Lights, Disturbing Hallway, Waterfall Cave, Rockslide Cavern, Den of Darkness, Luminous Gardens, Nasty Passage and Vault of Vastness
.
You are in Marble Halls
The number of viable directions is 2.

Marble Halls
White flowstone gleams in thick curtains on the walls of this magnificent hall.

Exits: south (Chilly Mausoleum) or up (Uncanny Lair)

>s
You're going to a VISITED room.

Unvisted: Shorehaven, Evil Archives, Librarian's Lair, Glittering Shrine, Vault of Secrets, Chamber of Lights, Disturbing Hallway, Waterfall Cave, Rockslide Cavern, Den of Darkness, Luminous Gardens, Nasty Passage and Vault of Vastness
.
You are in Chilly Mausoleum
The number of viable directions is 2.

Chilly Mausoleum
Cold seeps into your bones. Faceless tombs loom overhead.

Exits: north (Marble Halls) or east (Cavern of the Lake of Tears)

>e
You're going to a VISITED room.

Unvisted: Shorehaven, Evil Archives, Librarian's Lair, Glittering Shrine, Vault of Secrets, Chamber of Lights, Disturbing Hallway, Waterfall Cave, Rockslide Cavern, Den of Darkness, Luminous Gardens, Nasty Passage and Vault of Vastness
.
You are in Cavern of the Lake of Tears
The number of viable directions is 2.

Cavern of the Lake of Tears
A still, deep lake stretches into the distance. It's vast. You can't see the other side.

Exits: east (Webby Corridor) or west (Chilly Mausoleum)

>e
You're going to a VISITED room.

Unvisted: Shorehaven, Evil Archives, Librarian's Lair, Glittering Shrine, Vault of Secrets, Chamber of Lights, Disturbing Hallway, Waterfall Cave, Rockslide Cavern, Den of Darkness, Luminous Gardens, Nasty Passage and Vault of Vastness
.
You are in Webby Corridor
The number of viable directions is 2.

Webby Corridor
Dusty ropes of thick spiderweb festoon the walls.

Exits: north (Hall of Time) or west (Cavern of the Lake of Tears)

>w
You're going to a VISITED room.

Unvisted: Shorehaven, Evil Archives, Librarian's Lair, Glittering Shrine, Vault of Secrets, Chamber of Lights, Disturbing Hallway, Waterfall Cave, Rockslide Cavern, Den of Darkness, Luminous Gardens, Nasty Passage and Vault of Vastness
.
You are in Cavern of the Lake of Tears
The number of viable directions is 2.

Cavern of the Lake of Tears
A still, deep lake stretches into the distance. It's vast. You can't see the other side.

Exits: east (Webby Corridor) or west (Chilly Mausoleum)

>swim
The water feels great!
Ominous, like a grim battleship, you glide across the crystal waters.

Exits: east (Webby Corridor) or west (Chilly Mausoleum)

>e
You're going to a VISITED room.

You get out of the water.
Unvisted: Shorehaven, Evil Archives, Librarian's Lair, Glittering Shrine, Vault of Secrets, Chamber of Lights, Disturbing Hallway, Waterfall Cave, Rockslide Cavern, Den of Darkness, Luminous Gardens, Nasty Passage and Vault of Vastness
.
You are in Webby Corridor
The number of viable directions is 2.

Webby Corridor
Dusty ropes of thick spiderweb festoon the walls.

Exits: north (Hall of Time) or west (Cavern of the Lake of Tears)

>n
You're going to a VISITED room.

Unvisted: Shorehaven, Evil Archives, Librarian's Lair, Glittering Shrine, Vault of Secrets, Chamber of Lights, Disturbing Hallway, Waterfall Cave, Rockslide Cavern, Den of Darkness, Luminous Gardens, Nasty Passage and Vault of Vastness
.
You are in the Hall of Time
The number of viable directions is 2.

Hall of Time
A long, narrow hall, flickering with light from magefire sconces. The painted walls show the progression of time through planets and stars, sun and moons.

Exits: south (Webby Corridor) or west (Jewelled Forest)

>w
You're going to a VISITED room.

Unvisted: Shorehaven, Evil Archives, Librarian's Lair, Glittering Shrine, Vault of Secrets, Chamber of Lights, Disturbing Hallway, Waterfall Cave, Rockslide Cavern, Den of Darkness, Luminous Gardens, Nasty Passage and Vault of Vastness
.
You are in Jewelled Forest
The number of viable directions is 2.

Jewelled Forest
Marvellous columns march down the length of this immense cave. Jewel-like lights shine from deep within.

Exits: east (Hall of Time) or west (Cavern of the Lake of Tears)

>w
You're going to a VISITED room.

Unvisted: Shorehaven, Evil Archives, Librarian's Lair, Glittering Shrine, Vault of Secrets, Chamber of Lights, Disturbing Hallway, Waterfall Cave, Rockslide Cavern, Den of Darkness, Luminous Gardens, Nasty Passage and Vault of Vastness
.
You are in Cavern of the Lake of Tears
The number of viable directions is 2.

Cavern of the Lake of Tears
A still, deep lake stretches into the distance. It's vast. You can't see the other side.

Exits: east (Webby Corridor) or west (Chilly Mausoleum)

* * *

>w
The number of viable directions is 1.
removing east because you just came from there 

Chilly Mausoleum
Cold seeps into your bones. Faceless tombs loom overhead.

You can see a tentacled horror here.

Exits: south (Webby Corridor) or east (Dungeon Entrance)

>peck ghost
You viciously peck the wispy ghost, causing 6 points of damage!
You viciously peck the wispy ghost, causing 10 points of damage!

The wispy ghost falls over, gasping in pain.
"That's it, I quit!" it yells.
The wispy ghost drags itself off into the darkness.

Exits: north (Webby Corridor) or east (Dungeon Entrance)

>e
You're going to a VISITED room.

You are in Dungeon Entrance
The number of viable directions is 1.

Dungeon Entrance
Stone walls, mildewed with glowing stuff, widen into a large bare room.

You can see a trophy case (empty) here.

Exits: west (Rockslide Cavern)

>w
You're going to a VISITED room.

You are in Rockslide Cavern
The number of viable directions is 2.

Rockslide Cavern
Boulders have tumbled down on one side of this cave. It's a tight squeeze to get by them.

Exits: north (Webby Corridor) or east (Dungeon Entrance)

>n
You are in Webby Corridor
The number of viable directions is 1.
You are in Webby Corridor for the FIRST time
~~~~ next room will be Marble Halls
available directions: north, south, east, west and down
removing south because you just came from there 
~~~~ next direction will be west

Webby Corridor
Dusty ropes of thick spiderweb festoon the walls.

You can see a confused adventurer here.

Exits: south (Rockslide Cavern) or west (Marble Halls)

>peck adventurer
You viciously peck the confused adventurer, causing 7 points of damage!
You viciously peck the confused adventurer, causing 7 points of damage!

The confused adventurer attacks you, causing 3 points of damage!

Exits: south (Rockslide Cavern) or west (Marble Halls)

>peck adventurer
You viciously peck the confused adventurer, causing 10 points of damage!
You viciously peck the confused adventurer, causing 8 points of damage!

The confused adventurer trips and falls.
"The dispatcher didn't warn us! This is too much!" it shrieks, scuttling away.
The confused adventurer drags itself off into the darkness.

Exits: south (Rockslide Cavern) or west (Marble Halls)

>w
You are in Marble Halls
The number of viable directions is 1.
You are in Marble Halls for the FIRST time
~~~~ next room will be Den of Darkness
available directions: north, south, east, west and down
removing east because you just came from there 
~~~~ next direction will be down

Marble Halls
White flowstone gleams in thick curtains on the walls of this magnificent hall.

Exits: east (Webby Corridor) or down (Den of Darkness)

>d
You are in Den of Darkness
The number of viable directions is 1.
You are in Den of Darkness for the FIRST time
~~~~ next room will be Chamber of Lights
available directions: north, south, east, west and down
~~~~ next direction will be south

Den of Darkness
The darkness softens, the room is hushed. It's hard to see your way out.

Exits: south (Chamber of Lights) or up (Marble Halls)

>s
You are in Chamber of Lights
The number of viable directions is 1.
You are in Chamber of Lights for the FIRST time
~~~~ next room will be Jewelled Forest
available directions: north, south, east, west and down
removing north because you just came from there 
~~~~ next direction will be down

Chamber of Lights
An uncanny mottled glow emanates from the walls of this high-ceilinged cavern.

You can see a tentacled horror here.

Exits: north (Den of Darkness) or down (Jewelled Forest)

>peck horror
You viciously peck the tentacled horror, causing 9 points of damage!
You viciously peck the tentacled horror, causing 7 points of damage!

The tentacled horror attacks you, causing 5 points of damage!
The tentacled horror attacks you, causing 4 points of damage!

You swoon.
The world shimmers and whirls.
You wake up nestled into a hollow of warm sand.
You feel completely healed after your nap.

Shorehaven
A peaceful, secluded little beach, just the right size for a dungeon-going goose. A good place to tuck your head under your wing for a short nap.

Exits: east (Cavern of the Lake of Tears)

>e
You are in Cavern of the Lake of Tears
The number of viable directions is 1.
You are in Cavern of the Lake of Tears for the FIRST time
~~~~ next room will be Jewelled Forest
available directions: north, south, east, west and down
removing east because you just came from there 
~~~~ next direction will be west

Cavern of the Lake of Tears
A still, deep lake stretches into the distance. It's vast. You can't see the other side.

You can see a cave snake here.

Exits: east (Jewelled Forest) or west (Jewelled Forest)

>e
You are in Jewelled Forest
The number of viable directions is 3.

Jewelled Forest
Marvellous columns march down the length of this immense cave. Jewel-like lights shine from deep within.

Exits: east (Cavern of the Lake of Tears) or west (Cavern of the Lake of Tears) or up (Chamber of Lights)

>w
You're going to a VISITED room.

You are in Cavern of the Lake of Tears
The number of viable directions is 1.
You are in Cavern of the Lake of Tears for the FIRST time
~~~~ next room will be Evil Archives
available directions: north, south, east, west and down
removing east because you just came from there 
~~~~ next direction will be south

Cavern of the Lake of Tears
A still, deep lake stretches into the distance. It's vast. You can't see the other side.

You can see a cave snake here.

Exits: south (Evil Archives) or east (Jewelled Forest)

>s
You are in Evil Archives
The number of viable directions is 1.
You are in Evil Archives for the FIRST time
~~~~ next room will be Hall of Time
available directions: north, south, east, west and down
removing north because you just came from there 
~~~~ next direction will be west

Evil Archives
Row upon row of moldering tomes, dust, and a sense of forboding fill this underground library.

You can see a spider here.

Exits: north (Cavern of the Lake of Tears) or west (Hall of Time)

>n
You're going to a VISITED room.

You are in Cavern of the Lake of Tears
The number of viable directions is 2.

Cavern of the Lake of Tears
A still, deep lake stretches into the distance. It's vast. You can't see the other side.

You can see a cave snake here.

Exits: south (Evil Archives) or east (Jewelled Forest)

>l
Cavern of the Lake of Tears
A still, deep lake stretches into the distance. It's vast. You can't see the other side.

You can see a cave snake here.

Exits: south (Evil Archives) or east (Jewelled Forest)

>peck snake
You viciously peck the cave snake, causing 7 points of damage!
You viciously peck the cave snake, causing 8 points of damage!

The cave snake trips and falls.
"I went to Monster Polytechnic for this?" it mutters as it turns to run.
The cave snake drags itself off into the darkness.

Exits: south (Evil Archives) or east (Jewelled Forest)

>s
You're going to a VISITED room.

You are in Evil Archives
The number of viable directions is 2.

Evil Archives
Row upon row of moldering tomes, dust, and a sense of forboding fill this underground library.

You can see a spider here.

Exits: north (Cavern of the Lake of Tears) or west (Hall of Time)

>peck spider
You viciously peck the spider, causing 5 points of damage!
You viciously peck the spider, causing 4 points of damage!

The spider attacks you, causing 1 points of damage!

Exits: north (Cavern of the Lake of Tears) or west (Hall of Time)

>peck spider
You viciously peck the spider, causing 6 points of damage!
You viciously peck the spider, causing 3 points of damage!

The spider leaps back in shock.
"Ow, that's going too far!" it mutters as it turns to run.
The spider drags itself off into the darkness.

Exits: north (Cavern of the Lake of Tears) or west (Hall of Time)

>w
You are in the Hall of Time
The number of viable directions is 1.
You are in the Hall of Time for the FIRST time
~~~~ next room will be Luminous Gardens
available directions: north, south, east, west and down
removing east because you just came from there 
~~~~ next direction will be west

Hall of Time
A long, narrow hall, flickering with light from magefire sconces. The painted walls show the progression of time through planets and stars, sun and moons.

Exits: east (Evil Archives) or west (Luminous Gardens)

>w
You are in Luminous Gardens
The number of viable directions is 1.
You are in Luminous Gardens for the FIRST time
~~~~ next room will be Uncanny Lair
available directions: north, south, east, west and down
removing east because you just came from there 
~~~~ next direction will be down

Luminous Gardens
Mushrooms the size of trees, glowing, are scattered among winding paths. Tiny lightning bugs flit between snow-pale cave blossoms.

Exits: east (Hall of Time) or down (Uncanny Lair)

>d
You are in Uncanny Lair
The number of viable directions is 1.
You are in Uncanny Lair for the FIRST time
~~~~ next room will be Waterfall Cave
available directions: north, south, east, west and down
~~~~ next direction will be east

Uncanny Lair
Oddly shaped bones are strewn about this rough cave. Some creature made a nest in one corner out of shredded fungus.

You can see an iridium bat here.

Exits: east (Waterfall Cave) or up (Luminous Gardens)

>peck bat
You viciously peck the iridium bat, causing 6 points of damage!
You viciously peck the iridium bat, causing 4 points of damage!

The iridium bat attacks you, causing 5 points of damage!

Exits: east (Waterfall Cave) or up (Luminous Gardens)

>peck bat
You viciously peck the iridium bat, causing 6 points of damage!

The iridium bat trips and falls.
"That's it, I quit!" it shrieks.
The iridium bat drags itself off into the darkness.

Exits: east (Waterfall Cave) or up (Luminous Gardens)

>up
You're going to a VISITED room.

You are in Luminous Gardens
The number of viable directions is 2.

Luminous Gardens
Mushrooms the size of trees, glowing, are scattered among winding paths. Tiny lightning bugs flit between snow-pale cave blossoms.

Exits: east (Hall of Time) or down (Uncanny Lair)

>d
You're going to a VISITED room.

You are in Uncanny Lair
The number of viable directions is 2.

Uncanny Lair
Oddly shaped bones are strewn about this rough cave. Some creature made a nest in one corner out of shredded fungus.

Exits: east (Waterfall Cave) or up (Luminous Gardens)

>e
You are in Waterfall Cave
The number of viable directions is 1.
You are in Waterfall Cave for the FIRST time
~~~~ next room will be Glittering Shrine
available directions: north, south, east, west and down
removing west because you just came from there 
~~~~ next direction will be east

Waterfall Cave
Water pours down from high above, catching on stalactites and glinting in the eerie glow from the walls. A little pool lies underneath.

You can see a lumbering mummy here.

Exits: east (Glittering Shrine) or west (Uncanny Lair)

>peck mummy
You viciously peck the lumbering mummy, causing 5 points of damage!
You viciously peck the lumbering mummy, causing 3 points of damage!

The lumbering mummy attacks you, causing 2 points of damage!

Exits: east (Glittering Shrine) or west (Uncanny Lair)

>peck mummy
You viciously peck the lumbering mummy, causing 10 points of damage!

The lumbering mummy falls over, gasping in pain.
"Scare the adventurers, they said, it's easy, they said," it mutters as it turns to run.
The lumbering mummy drags itself off into the darkness.

Exits: east (Glittering Shrine) or west (Uncanny Lair)

>e
You are in Glittering Shrine
The number of viable directions is 1.
You are in Glittering Shrine for the FIRST time
~~~~ next room will be Jewelled Forest
available directions: north, south, east, west and down
removing west because you just came from there 
~~~~ next direction will be east

Glittering Shrine
Flecks of shining mica gleam from granite walls.

You can see a grumpy kobold and an obsidian altar here.

Exits: east (Jewelled Forest) or west (Waterfall Cave)

>peck kobold
You viciously peck the grumpy kobold, causing 9 points of damage!
You viciously peck the grumpy kobold, causing 6 points of damage!

The grumpy kobold attacks you, causing 2 points of damage!

Exits: east (Jewelled Forest) or west (Waterfall Cave)

>peck kobold
You viciously peck the grumpy kobold, causing 8 points of damage!

The grumpy kobold leaps back in shock.
"Ow, that's going too far!" it yelps.
The grumpy kobold drags itself off into the darkness.

Exits: east (Jewelled Forest) or west (Waterfall Cave)

>e
You're going to a VISITED room.

You are in Jewelled Forest
The number of viable directions is 3.

Jewelled Forest
Marvellous columns march down the length of this immense cave. Jewel-like lights shine from deep within.

Exits: east (Cavern of the Lake of Tears) or west (Glittering Shrine) or up (Chamber of Lights)

>e
You're going to a VISITED room.

You are in Cavern of the Lake of Tears
The number of viable directions is 2.

Cavern of the Lake of Tears
A still, deep lake stretches into the distance. It's vast. You can't see the other side.

Exits: south (Evil Archives) or east (Jewelled Forest)

>s
You're going to a VISITED room.

You are in Evil Archives
The number of viable directions is 2.

Evil Archives
Row upon row of moldering tomes, dust, and a sense of forboding fill this underground library.

Exits: north (Cavern of the Lake of Tears) or west (Hall of Time)

>w
You're going to a VISITED room.

You are in the Hall of Time
The number of viable directions is 2.

Hall of Time
A long, narrow hall, flickering with light from magefire sconces. The painted walls show the progression of time through planets and stars, sun and moons.

Exits: east (Evil Archives) or west (Luminous Gardens)

* * *

>w
The number of viable directions is 1.
removing east because you just came from there 

Chilly Mausoleum
Cold seeps into your bones. Faceless tombs loom overhead.

You can see a tentacled horror here.

Exits: south (Webby Corridor) or east (Dungeon Entrance)

>peck horror
You viciously peck the tentacled horror, causing 3 points of damage!
You viciously peck the tentacled horror, causing 9 points of damage!

The tentacled horror attacks you, causing 6 points of damage!
The tentacled horror attacks you, causing 6 points of damage!

You swoon.
The world shimmers and whirls.
You wake up nestled into a hollow of warm sand.
You feel completely healed after your nap.

Shorehaven
A peaceful, secluded little beach, just the right size for a dungeon-going goose. A good place to tuck your head under your wing for a short nap. Or you can swim out into the lake.

>swim
The water feels great!
Ominous, like a grim battleship, you glide across the crystal waters.

Cavern of the Lake of Tears
A still, deep lake stretches into the distance. It's vast. You can't see the other side.

~~~~ next direction will be west

Exits: west (Webby Corridor)

>w
You get out of the water.
The number of viable directions is 2.

Webby Corridor
Dusty ropes of thick spiderweb festoon the walls.

Exits: north (Chilly Mausoleum) or east (Cavern of the Lake of Tears)

>e
You're going to a VISITED room.

The number of viable directions is 1.
removing west because you just came from there 

Cavern of the Lake of Tears
A still, deep lake stretches into the distance. It's vast. You can't see the other side.

Exits: south (Uncanny Lair) or west (Webby Corridor)

>s
The number of viable directions is 1.
removing north because you just came from there 

Uncanny Lair
Oddly shaped bones are strewn about this rough cave. Some creature made a nest in one corner out of shredded fungus.

You can see a confused adventurer here.

Exits: north (Cavern of the Lake of Tears) or east (Chamber of Lights)

>peck adventurer
You viciously peck the confused adventurer, causing 5 points of damage!
You viciously peck the confused adventurer, causing 3 points of damage!

The confused adventurer attacks you, causing 2 points of damage!

Exits: north (Cavern of the Lake of Tears) or east (Chamber of Lights)

>peck adventurer
You viciously peck the confused adventurer, causing 10 points of damage!
You viciously peck the confused adventurer, causing 5 points of damage!

The confused adventurer attacks you, causing 4 points of damage!

Exits: north (Cavern of the Lake of Tears) or east (Chamber of Lights)

>peck adventurer
You viciously peck the confused adventurer, causing 6 points of damage!

The confused adventurer leaps back in shock.
"Mama always told me never to cross a dungeon picket line," it whines, cringing.
The confused adventurer drags itself off into the darkness.

Exits: north (Cavern of the Lake of Tears) or east (Chamber of Lights)

[Your score has just gone up by one point.]

>l
Uncanny Lair
Oddly shaped bones are strewn about this rough cave. Some creature made a nest in one corner out of shredded fungus.

Exits: north (Cavern of the Lake of Tears) or east (Chamber of Lights)

>e
The number of viable directions is 1.
removing west because you just came from there 

Chamber of Lights
An uncanny mottled glow emanates from the walls of this high-ceilinged cavern.

You can see a wispy ghost here.

Exits: east (Disturbing Hallway) or west (Uncanny Lair)

>peck ghost
You viciously peck the wispy ghost, causing 7 points of damage!
You viciously peck the wispy ghost, causing 7 points of damage!

The wispy ghost falls over, gasping in pain.
"Level 1 humans only, that's what they promised," it whines, cringing.
The wispy ghost drags itself off into the darkness.

Exits: east (Disturbing Hallway) or west (Uncanny Lair)

[Your score has just gone up by one point.]

>e
The number of viable directions is 1.
removing west because you just came from there 

Disturbing Hallway
The angles here, the colors, the feel of the air -- just wrong. Horribly wrong.

You can see a glowering elf here.

Exits: north (Marble Halls) or west (Chamber of Lights)

>stats
Strength: 3   Ferocity: 2   HP: 4/10 

Exits: north (Marble Halls) or west (Chamber of Lights)

>n
The number of viable directions is 1.
removing south because you just came from there 

Marble Halls
White flowstone gleams in thick curtains on the walls of this magnificent hall.

You can see a gelatinous cube here.

Exits: south (Disturbing Hallway) or east (Webby Corridor)

>nap
You take a quick snooze and wake up again, feeling frisky.

Exits: south (Disturbing Hallway) or east (Webby Corridor)

>stats
Strength: 3   Ferocity: 2   HP: 4/10 

Exits: south (Disturbing Hallway) or east (Webby Corridor)

>peck cube
You viciously peck the gelatinous cube, causing 7 points of damage!
You viciously peck the gelatinous cube, causing 3 points of damage!

The gelatinous cube attacks you, causing 5 points of damage!

You swoon.
The world shimmers and whirls.
You wake up nestled into a hollow of warm sand.
You feel completely healed after your nap.

Shorehaven
A peaceful, secluded little beach, just the right size for a dungeon-going goose. A good place to tuck your head under your wing for a short nap. Or you can swim out into the lake.

>swim
The water feels great!
Ominous, like a grim battleship, you glide across the crystal waters.

Cavern of the Lake of Tears
A still, deep lake stretches into the distance. It's vast. You can't see the other side.

~~~~ next direction will be south

Exits: south (Evil Archives) or west (Webby Corridor)

>s
You get out of the water.
The number of viable directions is 1.
removing north because you just came from there 

Evil Archives
Row upon row of moldering tomes, dust, and a sense of forboding fill this underground library.

Exits: north (Cavern of the Lake of Tears) or west (Waterfall Cave)

>w
The number of viable directions is 1.
removing east because you just came from there 

Waterfall Cave
Water pours down from high above, catching on stalactites and glinting in the eerie glow from the walls. A little pool lies underneath.

You can see an iridium bat here.

Exits: east (Evil Archives) or down (Webby Corridor)

>e
You're going to a VISITED room.

The number of viable directions is 2.

Evil Archives
Row upon row of moldering tomes, dust, and a sense of forboding fill this underground library.

Exits: north (Cavern of the Lake of Tears) or west (Waterfall Cave)

>w
You're going to a VISITED room.

The number of viable directions is 2.

Waterfall Cave
Water pours down from high above, catching on stalactites and glinting in the eerie glow from the walls. A little pool lies underneath.

You can see an iridium bat here.

Exits: east (Evil Archives) or down (Webby Corridor)

>d
You're going to a VISITED room.

The number of viable directions is 4.

Webby Corridor
Dusty ropes of thick spiderweb festoon the walls.

Exits: north (Chilly Mausoleum) or east (Cavern of the Lake of Tears) or west (Marble Halls) or up (Waterfall Cave)

* * *

>w
The number of viable directions is 1.
removing east because you just came from there 

Chilly Mausoleum
Cold seeps into your bones. Faceless tombs loom overhead.

You can see a tentacled horror here.

Exits: south (Webby Corridor) or east (Dungeon Entrance)

>peck mummy
You viciously peck the lumbering mummy, causing 4 points of damage!
You viciously peck the lumbering mummy, causing 5 points of damage!

The lumbering mummy attacks you, causing 4 points of damage!

Exits: north (Evil Archives) or east (Dungeon Entrance)

>peck mummy
You viciously peck the lumbering mummy, causing 8 points of damage!

The lumbering mummy leaps back in shock.
"Mama always told me never to cross a dungeon picket line," it mutters.
The lumbering mummy drags itself off into the darkness.

Exits: north (Evil Archives) or east (Dungeon Entrance)

>n
Evil Archives
Row upon row of moldering tomes, dust, and a sense of forboding fill this underground library.

Exits: south (Chamber of Lights) or down (Marble Halls)

>d
Marble Halls
White flowstone gleams in thick curtains on the walls of this magnificent hall.

You can see a tentacled horror here.

Exits: west (Luminous Gardens) or up (Evil Archives)

>peck horror
You viciously peck the tentacled horror, causing 6 points of damage!
You viciously peck the tentacled horror, causing 7 points of damage!

The tentacled horror attacks you, causing 6 points of damage!
The tentacled horror attacks you, causing 4 points of damage!

You swoon.
The world shimmers and whirls.
You wake up nestled into a hollow of warm sand.
You feel completely healed after your nap.

Shorehaven
A peaceful, secluded little beach, just the right size for a dungeon-going goose. A good place to tuck your head under your wing for a short nap.

Exits: east (Cavern of the Lake of Tears)

>stats
Strength: 3   Ferocity: 2   HP: 10/10 

Exits: east (Cavern of the Lake of Tears)

>nap
You aren't feeling especially drowsy.

Exits: east (Cavern of the Lake of Tears)

* * *

>w
The number of viable directions is 1.
removing east because you just came from there 

Chilly Mausoleum
Cold seeps into your bones. Faceless tombs loom overhead.

You can see a tentacled horror here.

Exits: south (Webby Corridor) or east (Dungeon Entrance)

>s
Webby Corridor
Dusty ropes of thick spiderweb festoon the walls.

You can see a cave snake here.

Exits: north (Rockslide Cavern) or east (Nasty Passage)

>peck snake
You attack the cave snake, causing 6 points of damage!
You attack the cave snake, causing 8 points of damage!

The cave snake falls over, gasping in pain. It drags itself off into the darkness.

Exits: north (Rockslide Cavern) or east (Nasty Passage)

>e
Nasty Passage
A tight squeeze between damp and slimy boulders. There is blood on the ground.

Exits: south (Disturbing Hallway) or west (Webby Corridor)

I beg your pardon?

>s
Disturbing Hallway
The angles here, the colors, the feel of the air -- just wrong. Horribly wrong.

You can see a gelatinous cube here.

Exits: north (Nasty Passage) or east (Den of Darkness)

>e
Den of Darkness
The darkness softens, the room is hushed. It's hard to see your way out.

Exits: west (Disturbing Hallway) or down (Vault of Vastness)

>d
Vault of Vastness
Soaring arches overhead, stone display cases and cubbyholes in the walls. The treasure hall of a dragon, emptied of its loot.

You can see a tentacled horror here.

Exits: up (Den of Darkness) or down (Chamber of Lights)

>kill horror
You attack the tentacled horror, causing 8 points of damage!
You attack the tentacled horror, causing 3 points of damage!

The tentacled horror attacks you, causing 5 points of damage!

The tentacled horror attacks you, causing 6 points of damage!

You swoon.
The world shimmers and whirls.
You wake up nestled into a hollow of warm sand.
You feel completely healed after your nap.

Shorehaven
A peaceful, secluded little beach, just the right size for a dungeon-going goose. A good place to tuck your head under your wing for a short nap.

Exits: east (Cavern of the Lake of Tears)

* * *

>d
You waddle valiantly forth.

The walls rumble. Rocks fall.
You can't see the sky anymore!
There is no way out.

Dungeon Entrance
Stone walls, mildewed with glowing stuff, widen into a large cold room. 

A large, colorful sign is on the wall.

You can see a healing potion and a trophy case (closed) here.

Exits: east (Rockslide Cavern)

>peck snake
You viciously peck the cave snake, causing 10 points of damage!
You viciously peck the cave snake, causing 5 points of damage!

The cave snake leaps back in shock.
"What ARE you?" it mutters.
The cave snake drags itself off into the darkness.

Exits: south (Jewelled Forest)

[Your score has just gone up by one point.]

>peck rat
You viciously peck the giant rat, causing 5 points of damage!
You viciously peck the giant rat, causing 8 points of damage!

The giant rat falls over, gasping in pain.
"Scare the adventurers, they said, it's easy, they said," it mutters.
The giant rat drags itself off into the darkness.

Exits: south (Jewelled Forest)

[Your score has just gone up by one point.]

>l
Dungeon Entrance
Stone walls, mildewed with glowing stuff, widen into a large bare room.

You can see a trophy case (empty) here.

Exits: west (Uncanny Lair)

>w
Uncanny Lair
Oddly shaped bones are strewn about this rough cave. Some creature made a nest in one corner out of shredded fungus.

You can see a spider here.

Exits: east (Dungeon Entrance) or down (Disturbing Hallway)

>peck spider
You viciously peck the spider, causing 7 points of damage!
You viciously peck the spider, causing 9 points of damage!

The spider falls over, gasping in pain.
"Ow, that's going too far!" it yelps.
The spider drags itself off into the darkness.

Exits: east (Dungeon Entrance) or down (Disturbing Hallway)

>d
Disturbing Hallway
The angles here, the colors, the feel of the air -- just wrong. Horribly wrong.

You can see a confused adventurer here.

Exits: up (Uncanny Lair) or down (Jewelled Forest)

>peck adventurer
You viciously peck the confused adventurer, causing 8 points of damage!
You viciously peck the confused adventurer, causing 9 points of damage!

The confused adventurer attacks you, causing 3 points of damage!

Exits: up (Uncanny Lair) or down (Jewelled Forest)

>peck adventurer
You viciously peck the confused adventurer, causing 5 points of damage!
You viciously peck the confused adventurer, causing 3 points of damage!

The confused adventurer attacks you, causing 3 points of damage!

Exits: up (Uncanny Lair) or down (Jewelled Forest)

>peck adventurer
You viciously peck the confused adventurer, causing 9 points of damage!

The confused adventurer trips and falls.
"Level 1 humans only, that's what they promised," it shrieks.
The confused adventurer drags itself off into the darkness.

Exits: up (Uncanny Lair) or down (Jewelled Forest)

>d
Jewelled Forest
Marvellous columns march down the length of this immense cavern. Jewel-like lights shine from deep within.

Exits: west (Cavern of the Lake of Tears) or up (Disturbing Hallway) or down (Waterfall Cave)

>w
Cavern of the Lake of Tears
A still, deep lake stretches into the distance. It's vast. You can't see the other side.

Exits: south (Glittering Shrine) or east (Jewelled Forest)

>s
Glittering Shrine
Flecks of shining mica gleam from granite walls.

You can see a gelatinous cube and an obsidian altar here.

Exits: north (Cavern of the Lake of Tears) or east (Webby Corridor)

>e
Webby Corridor
Dusty ropes of thick spiderweb festoon the walls.

You can see a soot sprite here.

Exits: north (Chilly Mausoleum) or west (Glittering Shrine)

>n
Chilly Mausoleum
Cold seeps into your bones. Faceless tombs loom overhead.

You can see a lumbering mummy here.

Exits: north (Den of Darkness) or south (Webby Corridor)

>n
Den of Darkness
The darkness softens, the room is hushed. It's hard to see your way out.

Exits: south (Chilly Mausoleum) or down (Nasty Passage)

>d
Nasty Passage
A tight squeeze between damp and slimy boulders. There is blood on the ground.

You can see a tentacled horror here.

Exits: up (Den of Darkness) or down (Evil Archives)

>peck horror
You viciously peck the tentacled horror, causing 7 points of damage!
You viciously peck the tentacled horror, causing 10 points of damage!

The tentacled horror attacks you, causing 6 points of damage!

You swoon.
The world shimmers and whirls.
You wake up nestled into a hollow of warm sand.
You feel completely healed after your nap.

Shorehaven
A peaceful, secluded little beach, just the right size for a dungeon-going goose. A good place to tuck your head under your wing for a short nap.

Exits: east (Cavern of the Lake of Tears)

>e
Cavern of the Lake of Tears
A still, deep lake stretches into the distance. It's vast. You can't see the other side.

You can see a glowering elf here.

Exits: north (Marble Halls) or south (Glittering Shrine) or east (Jewelled Forest)

>peck elf
You viciously peck the glowering elf, causing 3 points of damage!
You viciously peck the glowering elf, causing 6 points of damage!

The glowering elf attacks you, causing 4 points of damage!
The glowering elf attacks you, causing 4 points of damage!

Exits: north (Marble Halls) or south (Glittering Shrine) or east (Jewelled Forest)

>peck elf
You viciously peck the glowering elf, causing 5 points of damage!
You viciously peck the glowering elf, causing 9 points of damage!

The glowering elf attacks you, causing 4 points of damage!

You swoon.
The world shimmers and whirls.
You wake up nestled into a hollow of warm sand.
You feel completely healed after your nap.

Shorehaven
A peaceful, secluded little beach, just the right size for a dungeon-going goose. A good place to tuck your head under your wing for a short nap.

Exits: east (Cavern of the Lake of Tears)

>e
Cavern of the Lake of Tears
A still, deep lake stretches into the distance. It's vast. You can't see the other side.

You can see a grumpy kobold and a glowering elf here.

Exits: north (Marble Halls) or south (Glittering Shrine) or east (Jewelled Forest) or west (Luminous Gardens)

>e
Jewelled Forest
Marvellous columns march down the length of this immense cavern. Jewel-like lights shine from deep within.

You can see a wispy ghost here.

Exits: north (Rockslide Cavern) or west (Cavern of the Lake of Tears) or up (Disturbing Hallway) or down (Waterfall Cave)

>peck ghost
You viciously peck the wispy ghost, causing 6 points of damage!
You viciously peck the wispy ghost, causing 3 points of damage!

The wispy ghost attacks you, causing 4 points of damage!

Exits: north (Rockslide Cavern) or west (Cavern of the Lake of Tears) or up (Disturbing Hallway) or down (Waterfall Cave)

>peck ghost
You viciously peck the wispy ghost, causing 4 points of damage!

The wispy ghost falls over, gasping in pain.
"Ow, that's going too far!" it yelps.
The wispy ghost drags itself off into the darkness.

Exits: north (Rockslide Cavern) or west (Cavern of the Lake of Tears) or up (Disturbing Hallway) or down (Waterfall Cave)

>d
Waterfall Cave
Water pours down from high above, catching on stalactites and glinting in the eerie glow from the walls. A little pool lies underneath.

You can see an iridium bat here.

Exits: west (Marble Halls) or up (Jewelled Forest)

>w
Marble Halls
White flowstone gleams in thick curtains on the walls of this magnificent hall.

Exits: south (Cavern of the Lake of Tears) or east (Waterfall Cave) or west (Chamber of Lights)

>w
Chamber of Lights
An uncanny mottled glow emanates from the walls of this high-ceilinged cavern.

Exits: east (Marble Halls) or west (Luminous Gardens)

>w
Luminous Gardens
Mushrooms the size of trees, glowing, are scattered among winding paths. Tiny lightning bugs flit between snow-pale cave blossoms.

Exits: north (Evil Archives) or east (Chamber of Lights)

>n
Evil Archives
Row upon row of moldering tomes, dust, and a sense of forboding fill this underground library.

Exits: south (Luminous Gardens) or east (Rockslide Cavern) or up (Nasty Passage)

>up
Nasty Passage
A tight squeeze between damp and slimy boulders. There is blood on the ground.

You can see a tentacled horror here.

Exits: south (Hall of Time) or up (Den of Darkness) or down (Evil Archives)

>s
Hall of Time
A long, narrow hall, flickering with light from magefire sconces. The painted walls show the progression of time through planets and stars, sun and moons.

Exits: north (Nasty Passage) or west (Rockslide Cavern)

>w
Exits: south (Jewelled Forest) or east (Hall of Time) or west (Evil Archives)

>s
Exits: north (Rockslide Cavern) or west (Cavern of the Lake of Tears) or up (Disturbing Hallway) or down (Waterfall Cave)

>n
Exits: south (Jewelled Forest) or east (Hall of Time) or west (Evil Archives)

>w
Exits: south (Luminous Gardens) or east (Rockslide Cavern) or up (Nasty Passage)

>e
Exits: south (Jewelled Forest) or east (Hall of Time) or west (Evil Archives)

>e
Exits: north (Nasty Passage) or west (Rockslide Cavern)

>n
Exits: south (Hall of Time) or up (Den of Darkness) or down (Evil Archives)

>up
Exits: south (Chilly Mausoleum) or down (Nasty Passage)

>l
Den of Darkness
The darkness softens, the room is hushed. It's hard to see your way out.

Exits: south (Chilly Mausoleum) or down (Nasty Passage)

>d
Exits: south (Hall of Time) or up (Den of Darkness) or down (Evil Archives)

>l
Nasty Passage
A tight squeeze between damp and slimy boulders. There is blood on the ground.

You can see a tentacled horror here.

Exits: south (Hall of Time) or up (Den of Darkness) or down (Evil Archives)

>d
Exits: south (Luminous Gardens) or east (Rockslide Cavern) or up (Nasty Passage)

* * *

>peck rat
You viciously peck the giant rat, causing 5 points of damage!
You viciously peck the giant rat, causing 8 points of damage!

The giant rat falls over, gasping in pain.
"Scare the adventurers, they said, it's easy, they said," it mutters.
The giant rat drags itself off into the darkness.

Exits: south (Jewelled Forest)

[Your score has just gone up by one point.]

>s
The number of viable directions is 1.
removing north because you just came from there 

Jewelled Forest
Marvellous columns march down the length of this immense cave. Jewel-like lights shine from deep within.

Exits: north (Dungeon Entrance) or south (Luminous Gardens)

>s
The number of viable directions is 1.
removing north because you just came from there 

Luminous Gardens
Mushrooms the size of trees, glowing, are scattered among winding paths. Tiny lightning bugs flit between snow-pale cave blossoms.

You can see a grumpy kobold here.

Exits: north (Jewelled Forest) or down (Waterfall Cave)

>peck kobold
You viciously peck the grumpy kobold, causing 3 points of damage!
You viciously peck the grumpy kobold, causing 3 points of damage!

The grumpy kobold attacks you, causing 3 points of damage!

Exits: north (Jewelled Forest) or down (Waterfall Cave)

>peck kobold
You viciously peck the grumpy kobold, causing 8 points of damage!
You viciously peck the grumpy kobold, causing 4 points of damage!

The grumpy kobold attacks you, causing 3 points of damage!

Exits: north (Jewelled Forest) or down (Waterfall Cave)

>peck kobold
You viciously peck the grumpy kobold, causing 5 points of damage!

The grumpy kobold leaps back in shock.
"Ow, that's going too far!" it yelps.
The grumpy kobold drags itself off into the darkness.

Exits: north (Jewelled Forest) or down (Waterfall Cave)

[Your score has just gone up by one point.]

>stats
Strength: 3   Ferocity: 2   HP: 4/10 

Exits: north (Jewelled Forest) or down (Waterfall Cave)

>d
The number of viable directions is 1.

Waterfall Cave
Water pours down from high above, catching on stalactites and glinting in the eerie glow from the walls. A little pool lies underneath.

You can see a gelatinous cube here.

Exits: west (Marble Halls) or up (Luminous Gardens)

>w
The number of viable directions is 1.
removing east because you just came from there 

Marble Halls
White flowstone gleams in thick curtains on the walls of this magnificent hall.

Exits: east (Waterfall Cave) or west (Evil Archives)

>e
You're going to a VISITED room.

The number of viable directions is 2.

Waterfall Cave
Water pours down from high above, catching on stalactites and glinting in the eerie glow from the walls. A little pool lies underneath.

You can see a gelatinous cube here.

Exits: west (Marble Halls) or up (Luminous Gardens)

>w
You're going to a VISITED room.

The number of viable directions is 2.

Marble Halls
White flowstone gleams in thick curtains on the walls of this magnificent hall.

Exits: east (Waterfall Cave) or west (Evil Archives)

>w
The number of viable directions is 1.
removing east because you just came from there 

Evil Archives
Row upon row of moldering tomes, dust, and a sense of forboding fill this underground library.

Exits: east (Marble Halls) or down (Disturbing Hallway)

>d
The number of viable directions is 1.

Disturbing Hallway
The angles here, the colors, the feel of the air -- just wrong. Horribly wrong.

You can see a soot sprite here.

Exits: west (Uncanny Lair) or up (Evil Archives)

>peck sprite
You viciously peck the soot sprite, causing 6 points of damage!
You viciously peck the soot sprite, causing 5 points of damage!

The soot sprite leaps back in shock.
"Scare the adventurers, they said, it's easy, they said," it whines, cringing.
The soot sprite drags itself off into the darkness.

Exits: west (Uncanny Lair) or up (Evil Archives)

[Your score has just gone up by one point.]

>w
The number of viable directions is 1.
removing east because you just came from there 

Uncanny Lair
Oddly shaped bones are strewn about this rough cave. Some creature made a nest in one corner out of shredded fungus.

Exits: south (Den of Darkness) or east (Disturbing Hallway)

>s
The number of viable directions is 1.
removing north because you just came from there 

Den of Darkness
The darkness softens, the room is hushed. It's hard to see your way out.

Exits: north (Uncanny Lair) or down (Chilly Mausoleum)

>d
The number of viable directions is 1.

Chilly Mausoleum
Cold seeps into your bones. Faceless tombs loom overhead.

Exits: east (Hall of Time) or up (Den of Darkness)

>e
The number of viable directions is 1.
removing west because you just came from there 

Hall of Time
A long, narrow hall, flickering with light from magefire sconces. The painted walls show the progression of time through planets and stars, sun and moons.

Exits: south (Webby Corridor) or west (Chilly Mausoleum)

>s
The number of viable directions is 1.
removing north because you just came from there 

Webby Corridor
Dusty ropes of thick spiderweb festoon the walls.

Exits: north (Hall of Time) or east (Chamber of Lights)

>e
The number of viable directions is 1.
removing west because you just came from there 

Chamber of Lights
An uncanny mottled glow emanates from the walls of this high-ceilinged cavern.

Exits: east (Rockslide Cavern) or west (Webby Corridor)

>e
The number of viable directions is 1.
removing west because you just came from there 

Rockslide Cavern
Boulders have tumbled down on one side of this cave. It's a tight squeeze to get by them.

You can see a spider here.

Exits: east (Nasty Passage) or west (Chamber of Lights)

>peck spider
You viciously peck the spider, causing 10 points of damage!
You viciously peck the spider, causing 3 points of damage!

The spider attacks you, causing 3 points of damage!

Exits: east (Nasty Passage) or west (Chamber of Lights)

>peck spider
You viciously peck the spider, causing 5 points of damage!

The spider falls over, gasping in pain.
"The dispatcher didn't warn us! This is too much!" it mutters.
The spider drags itself off into the darkness.

Exits: east (Nasty Passage) or west (Chamber of Lights)

[Your score has just gone up by one point.]

>stats
Strength: 3   Ferocity: 2   HP: 1/10 

Exits: east (Nasty Passage) or west (Chamber of Lights)

* * *

>peck snake
You viciously peck the cave snake, causing 10 points of damage!
You viciously peck the cave snake, causing 5 points of damage!

The cave snake leaps back in shock.
"What ARE you?" it mutters.
The cave snake drags itself off into the darkness.

Exits: south (Jewelled Forest)

[Your score has just gone up by one point.]

>peck snake
You viciously peck the cave snake, causing 10 points of damage!

The cave snake leaps back in shock.
"Oooh, that smarts," it whines, cringing.
The cave snake drags itself off into the darkness.

Exits: down (Glittering Shrine)

[Your score has just gone up by one point.]

>peck rat
You viciously peck the giant rat, causing 7 points of damage!

The giant rat leaps back in shock.
"Ouch! I'm out of here!" it yells.
The giant rat drags itself off into the darkness.

Exits: down (Glittering Shrine)

[Your score has just gone up by one point.]

>d
The number of viable directions is 1.

Glittering Shrine
Flecks of shining mica gleam from granite walls.

You can see a glowering elf and an obsidian altar here.

Exits: south (Evil Archives) or up (Dungeon Entrance)

>peck elf
You viciously peck the glowering elf, causing 8 points of damage!
You viciously peck the glowering elf, causing 9 points of damage!

The glowering elf attacks you, causing 5 points of damage!
The glowering elf attacks you, causing 3 points of damage!

You swoon.
The world shimmers and whirls.
You wake up nestled into a hollow of warm sand.
You feel completely healed after your nap.

Shorehaven
A peaceful, secluded little beach, just the right size for a dungeon-going goose. A good place to tuck your head under your wing for a short nap. Or you can swim out into the lake.

>swim
The water feels great!
Ominous, like a grim battleship, you glide across the crystal waters.

Cavern of the Lake of Tears
A still, deep lake stretches into the distance. It's vast. You can't see the other side.

~~~~ next direction will be west

Exits: west (Hall of Time)

>w
You get out of the water.
The number of viable directions is 1.
removing east because you just came from there 

Hall of Time
A long, narrow hall, flickering with light from magefire sconces. The painted walls show the progression of time through planets and stars, sun and moons.

You can see a spider here.

Exits: east (Cavern of the Lake of Tears) or west (Rockslide Cavern)

>e
You're going to a VISITED room.

The number of viable directions is 1.

Cavern of the Lake of Tears
A still, deep lake stretches into the distance. It's vast. You can't see the other side.

Exits: west (Hall of Time)

* * *

>d
You waddle valiantly forth.

The walls rumble. Rocks fall.
You can't see the sky anymore!
There is no way out.

Dungeon Entrance
Stone walls, mildewed with glowing stuff, widen into a large cold room. 

A large, colorful sign is on the wall.

You can see a healing potion and a trophy case (closed) here.

Exits: east (Rockslide Cavern)

>peck spider
You viciously peck the spider, causing 7 points of damage!
You viciously peck the spider, causing 5 points of damage!

The spider attacks you, causing 2 points of damage!

Exits: west (Webby Corridor)

>peck spider
You viciously peck the spider, causing 7 points of damage!

The spider trips and falls.
"Oooh, that smarts," it mutters.
The spider drags itself off into the darkness.

Exits: west (Webby Corridor)

>peck rat
You viciously peck the giant rat, causing 5 points of damage!
You viciously peck the giant rat, causing 7 points of damage!

The giant rat falls over, gasping in pain.
"That's it, I quit!" it yells.
The giant rat drags itself off into the darkness.

Exits: west (Webby Corridor)

>l
Dungeon Entrance
Stone walls, mildewed with glowing stuff, widen into a large bare room.

You can see a trophy case (empty) here.

Exits: west (Webby Corridor)

>stats
Strength: 3   Ferocity: 2   HP: 8/10 

Exits: west (Webby Corridor)

>w
Unvisted: Jewelled Forest, Cavern of the Lake of Tears, Shorehaven, Evil Archives, Librarian's Lair, Glittering Shrine, Vault of Secrets, Webby Corridor, Chamber of Lights, Disturbing Hallway, Waterfall Cave, Marble Halls, Rockslide Cavern, Uncanny Lair, Den of Darkness, Luminous Gardens, Nasty Passage, Chilly Mausoleum, Hall of Time and Vault of Vastness
.
You are in Webby Corridor
The number of viable directions is 1.
You are in Webby Corridor for the FIRST time
Unpicked: Jewelled Forest, Cavern of the Lake of Tears, Evil Archives, Glittering Shrine, Chamber of Lights, Disturbing Hallway, Waterfall Cave, Marble Halls, Rockslide Cavern, Uncanny Lair, Den of Darkness, Luminous Gardens, Nasty Passage, Chilly Mausoleum and Hall of Time.
~~~~ next room will be Jewelled Forest
available directions: north, south, east, west and down
removing east because you just came from there 
available directions: north, south, west and down
~~~~ next direction will be south

Webby Corridor
Dusty ropes of thick spiderweb festoon the walls.

You can see a glowering elf here.

Exits: south (Jewelled Forest) or east (Dungeon Entrance)

>peck elf
You viciously peck the glowering elf, causing 10 points of damage!
You viciously peck the glowering elf, causing 8 points of damage!

The glowering elf attacks you, causing 5 points of damage!
The glowering elf attacks you, causing 3 points of damage!

Exits: south (Jewelled Forest) or east (Dungeon Entrance)

>stats
Strength: 3   Ferocity: 2   HP: 0/10 

Exits: south (Jewelled Forest) or east (Dungeon Entrance)

>peck elf
You viciously peck the glowering elf, causing 8 points of damage!

The glowering elf falls over, gasping in pain.
"What ARE you?" it mutters as it turns to run.
The glowering elf drags itself off into the darkness.

Exits: south (Jewelled Forest) or east (Dungeon Entrance)

* * *

>d
You waddle valiantly forth.

The walls rumble. Rocks fall.
You can't see the sky anymore!
There is no way out.

Dungeon Entrance
Stone walls, mildewed with glowing stuff, widen into a large cold room. 

A large, colorful sign is on the wall.

You can see a healing potion and a trophy case (closed) here.

Exits: east (Rockslide Cavern)

>peck sprite
You viciously peck the soot sprite, causing 4 points of damage!
You viciously peck the soot sprite, causing 4 points of damage!

The soot sprite attacks you, causing 3 points of damage!

Exits: west (Cavern of the Lake of Tears)

>peck rat
You viciously peck the giant rat, causing 8 points of damage!

The giant rat leaps back in shock.
"The dispatcher didn't warn us! This is too much!" it shrieks, scuttling away.
The giant rat drags itself off into the darkness.

Exits: west (Cavern of the Lake of Tears)

>l
Dungeon Entrance
Stone walls, mildewed with glowing stuff, widen into a large bare room.

You can see a soot sprite and a trophy case (empty) here.

Exits: west (Cavern of the Lake of Tears)

>peck sprite
You viciously peck the soot sprite, causing 9 points of damage!

The soot sprite trips and falls.
"What ARE you?" it shrieks.
The soot sprite drags itself off into the darkness.

Exits: west (Cavern of the Lake of Tears)

>l
Dungeon Entrance
Stone walls, mildewed with glowing stuff, widen into a large bare room.

You can see a trophy case (empty) here.

Exits: west (Cavern of the Lake of Tears)

>w
The number of viable directions is 1.
removing east because you just came from there 

Cavern of the Lake of Tears
A still, deep lake stretches into the distance. It's vast. You can't see the other side.

You can see a cave snake here.

Exits: north (Jewelled Forest) or east (Dungeon Entrance)

>peck snake
You viciously peck the cave snake, causing 9 points of damage!
You viciously peck the cave snake, causing 6 points of damage!

The cave snake leaps back in shock.
"Level 1 humans only, that's what they promised," it yelps.
The cave snake drags itself off into the darkness.

Exits: north (Jewelled Forest) or east (Dungeon Entrance)

>l
Cavern of the Lake of Tears
A still, deep lake stretches into the distance. It's vast. You can't see the other side.

Exits: north (Jewelled Forest) or east (Dungeon Entrance)

>stats
Strength: 3   Ferocity: 2   HP: 7/10 

Exits: north (Jewelled Forest) or east (Dungeon Entrance)

>score
You have so far scored 0 out of a possible 0, in 11 turns.

* * *

>d
You waddle valiantly forth.

The walls rumble. Rocks fall.
You can't see the sky anymore!
There is no way out.

Dungeon Entrance
Stone walls, mildewed with glowing stuff, widen into a large cold room. 

A large, colorful sign is on the wall.

You can see a healing potion and a trophy case (closed) here.

Exits: east (Rockslide Cavern)

>quaff potion
(first taking the healing potion)
You feel more vigorous!

Exits: north (Marble Halls)

>stats
Strength: 3   Ferocity: 2   HP: 13/10 

Exits: north (Marble Halls)

>help
That's not a verb I recognise.

* * *

>d
You waddle valiantly forth.

The walls rumble. Rocks fall.
You can't see the sky anymore!
There is no way out.

Dungeon Entrance
Stone walls, mildewed with glowing stuff, widen into a large cold room. 

A large, colorful sign is on the wall.

You can see a healing potion and a trophy case (closed) here.

Exits: east (Rockslide Cavern)

>read sign
A glossy sign in bright orange and virulent green, with a stylized picture of a sword on a pile of money. It says, "Welcome to your new Dungeon Away From Home! Let AirDnD be your Guide, as we bring you to new depths in Adventuring! *AirDnD*

Exits: east (Webby Corridor)

>peck kobold
You viciously peck the grumpy kobold, causing 10 points of damage!
You viciously peck the grumpy kobold, causing 4 points of damage!

The grumpy kobold attacks you, causing 3 points of damage!

Exits: east (Webby Corridor)

>peck kobold
You viciously peck the grumpy kobold, causing 8 points of damage!

The grumpy kobold falls over, gasping in pain.
"That's it, I quit!" it yelps.
The grumpy kobold drags itself off into the darkness.

Exits: east (Webby Corridor)

[Your score has just gone up by one point.]

>l
Dungeon Entrance
Stone walls, mildewed with glowing stuff, widen into a large cold room. 

A large, colorful sign is on the wall.

You can see a trophy case (empty) here.

Exits: east (Webby Corridor)

>e
Grimly, you forge ever onward, tail waggling.

Webby Corridor
Dusty ropes of thick spiderweb festoon the walls. 
A brightly colored poster peeks out from beneath the webs.

Exits: north (Uncanny Lair) or west (Dungeon Entrance)

>read poster
A color painting of a sad looking gnome with a terrible haircut. Above the painting are glowing words, "MONSTER OF THE MONTH: Dnifter the Bald!" And under it, "Congrats to our newest Associate Assassin! *AirDnD*"

Exits: north (Uncanny Lair) or west (Dungeon Entrance)

* * *

>d
You waddle valiantly forth.

The walls rumble. Rocks fall.
You can't see the sky anymore!
There is no way out.

Dungeon Entrance
Stone walls, mildewed with glowing stuff, widen into a large cold room. 

A large, colorful sign is on the wall.

You can see a healing potion and a trophy case (closed) here.

Exits: east (Rockslide Cavern)

>s
You are in Luminous Gardens
The number of viable directions is 1.
You are in Luminous Gardens for the FIRST time
~~~~ next room will be Den of Darkness
available directions: north, south, east, west and down
removing north because you just came from there 
~~~~ next direction will be east

Luminous Gardens
Mushrooms the size of trees, glowing, are scattered among winding paths. Tiny lightning bugs flit between snow-pale cave blossoms.

Exits: north (Dungeon Entrance) or east (Den of Darkness)

>d
Evil Archives
Row upon row of moldering tomes, dust, and a sense of forboding fill this underground library.

You can see a soot sprite here.

Exits: up (Glittering Shrine) or down (Luminous Gardens)

>d
Luminous Gardens
Mushrooms the size of trees, glowing, are scattered among winding paths. Tiny lightning bugs flit between snow-pale cave blossoms.

You can see a spider here.

Exits: west (Uncanny Lair) or up (Evil Archives)

>w
Uncanny Lair
Oddly shaped bones are strewn about this rough cave. Some creature made a nest in one corner out of shredded fungus.

You can see a confused adventurer here.

Exits: east (Luminous Gardens) or west (Jewelled Forest)

>peck adventurer
You viciously peck the confused adventurer, causing 6 points of damage!
You viciously peck the confused adventurer, causing 3 points of damage!

The confused adventurer attacks you, causing 4 points of damage!

Exits: east (Luminous Gardens) or west (Jewelled Forest)

>peck adventurer
You viciously peck the confused adventurer, causing 3 points of damage!
You viciously peck the confused adventurer, causing 5 points of damage!

The confused adventurer attacks you, causing 2 points of damage!

Exits: east (Luminous Gardens) or west (Jewelled Forest)

>peck adventurer
You viciously peck the confused adventurer, causing 9 points of damage!

The confused adventurer leaps back in shock.
"I went to Monster Polytechnic for this?" it mutters as it turns to run.
The confused adventurer drags itself off into the darkness.

Exits: east (Luminous Gardens) or west (Jewelled Forest)

>w
Jewelled Forest
Marvellous columns march down the length of this immense cavern. Jewel-like lights shine from deep within.

You can see a tentacled horror here.

Exits: north (Den of Darkness) or east (Uncanny Lair) or west (Cavern of the Lake of Tears)

>w
Cavern of the Lake of Tears
A still, deep lake stretches into the distance. It's vast. You can't see the other side.

Exits: east (Jewelled Forest) or down (Den of Darkness)

>d
Den of Darkness
The darkness softens, the room is hushed. It's hard to see your way out.

Exits: south (Jewelled Forest) or east (Waterfall Cave) or up (Cavern of the Lake of Tears)

>e
Waterfall Cave
Water pours down from high above, catching on stalactites and glinting in the eerie glow from the walls. A little pool lies underneath.

You can see an iridium bat here.

Exits: north (Webby Corridor) or west (Den of Darkness)

>n
Webby Corridor
Dusty ropes of thick spiderweb festoon the walls.

Exits: south (Waterfall Cave) or east (Nasty Passage)

>e
Nasty Passage
A tight squeeze between damp and slimy boulders. There is blood on the ground.

You can see a cave snake here.

Exits: east (Rockslide Cavern) or west (Webby Corridor)

>e
Rockslide Cavern
Boulders have tumbled down on one side of this cave. It's a tight squeeze to get by them.

Exits: west (Nasty Passage) or down (Chamber of Lights)

>d
Chamber of Lights
An uncanny mottled glow emanates from the walls of this high-ceilinged cavern.

Exits: up (Rockslide Cavern) or down (Marble Halls)

>d
Marble Halls
White flowstone gleams in thick curtains on the walls of this magnificent hall.

You can see a grumpy kobold here.

Exits: north (Disturbing Hallway) or up (Chamber of Lights)

>m
That's not a verb I recognise.

>n
Disturbing Hallway
The angles here, the colors, the feel of the air -- just wrong. Horribly wrong.

Exits: north (Chilly Mausoleum) or south (Marble Halls)

>n
Chilly Mausoleum
Cold seeps into your bones. Faceless tombs loom overhead.

You can see a glowering elf here.

Exits: north (Hall of Time) or south (Disturbing Hallway)

>n
You have reached a dead end.
Something stirs in the darkness.

Exits: south (Chilly Mausoleum)

>l
Hall of Time
A long, narrow hall, flickering with light from magefire sconces. The painted walls show the progression of time through planets and stars, sun and moons.

You can see a sleeping dragon here.

Exits: south (Chilly Mausoleum)

>x dragon
You see nothing special about the sleeping dragon.

Exits: south (Chilly Mausoleum)

>wake dragon
That seems unnecessary.

Exits: south (Chilly Mausoleum)

* * *

>s
You are in Luminous Gardens
The number of viable directions is 1.
You are in Luminous Gardens for the FIRST time
~~~~ next room will be Den of Darkness
available directions: north, south, east, west and down
removing north because you just came from there 
~~~~ next direction will be east

Luminous Gardens
Mushrooms the size of trees, glowing, are scattered among winding paths. Tiny lightning bugs flit between snow-pale cave blossoms.

Exits: north (Dungeon Entrance) or east (Den of Darkness)

>e
You are in Den of Darkness
The number of viable directions is 1.
You are in Den of Darkness for the FIRST time
~~~~ next room will be Jewelled Forest
available directions: north, south, east, west and down
removing west because you just came from there 
~~~~ next direction will be east

Den of Darkness
The darkness softens, the room is hushed. It's hard to see your way out.

Exits: east (Jewelled Forest) or west (Luminous Gardens)

>d
Uncanny Lair
You can see a tentacled horror here.

Exits: east (Hall of Time) or up (Disturbing Hallway)

>e
Hall of Time
You can see a wispy ghost here.

Exits: south (Evil Archives) or west (Uncanny Lair)

>s
Evil Archives
You can see a gelatinous cube here.

Exits: north (Hall of Time) or east (Chamber of Lights)

>e
Chamber of Lights
An uncanny mottled glow emanates from the walls of this high-ceilinged cavern.

Exits: west (Evil Archives) or down (Chilly Mausoleum)

>d
Chilly Mausoleum
Exits: up (Chamber of Lights) or down (Nasty Passage)

>d
Nasty Passage
You can see a cave snake here.

Exits: south (Jewelled Forest) or up (Chilly Mausoleum)

>s
Jewelled Forest
You can see a spider here.

Exits: north (Nasty Passage) or south (Webby Corridor) or west (Cavern of the Lake of Tears)

>w
Cavern of the Lake of Tears
A still, deep lake stretches into the distance. It's vast. You can't see the other side.

Exits: south (Vault of Vastness) or east (Jewelled Forest) or west (Shorehaven)

>swim
The water feels great!
Ominous, like a grim battleship, you glide across the crystal waters.
You notice a little beach to the west.

Exits: south (Vault of Vastness) or east (Jewelled Forest) or west (Shorehaven)

* * *

>e
You are in Den of Darkness
The number of viable directions is 1.
You are in Den of Darkness for the FIRST time
~~~~ next room will be Jewelled Forest
available directions: north, south, east, west and down
removing west because you just came from there 
~~~~ next direction will be east

Den of Darkness
The darkness softens, the room is hushed. It's hard to see your way out.

Exits: east (Jewelled Forest) or west (Luminous Gardens)

>e
You are in Jewelled Forest
The number of viable directions is 1.
You are in Jewelled Forest for the FIRST time
~~~~ next room will be Evil Archives
available directions: north, south, east, west and down
removing west because you just came from there 
~~~~ next direction will be east

Jewelled Forest
Marvellous columns march down the length of this immense cavern. Jewel-like lights shine from deep within.

Exits: east (Evil Archives) or west (Den of Darkness)

>n
Marble Halls
White flowstone gleams in thick curtains on the walls of this magnificent hall.

You can see a tentacled horror here.

Exits: north (Vault of Vastness) or south (Uncanny Lair)

>n
Vault of Vastness
You can see a kobold here.

Exits: south (Marble Halls) or east (Waterfall Pool)

>e
Waterfall Pool
Water pours down from high above, catching on stalactites and glinting in the eerie glow from the walls. A little pool lies underneath.

You can see a cave snake here.

Exits: east (Den of Darkness) or west (Vault of Vastness)

>swim
Waterfall Pool isn't wet enough.

Exits: east (Den of Darkness) or west (Vault of Vastness)

* * *

>e
You are in Jewelled Forest
The number of viable directions is 1.
You are in Jewelled Forest for the FIRST time
~~~~ next room will be Evil Archives
available directions: north, south, east, west and down
removing west because you just came from there 
~~~~ next direction will be east

Jewelled Forest
Marvellous columns march down the length of this immense cavern. Jewel-like lights shine from deep within.

Exits: east (Evil Archives) or west (Den of Darkness)

>w
You're going to a VISITED room.

You are in Den of Darkness
The number of viable directions is 2.

Exits: east (Jewelled Forest) or west (Luminous Gardens)

>w
You're going to a VISITED room.

You are in Luminous Gardens
The number of viable directions is 2.

Exits: north (Dungeon Entrance) or east (Den of Darkness)

>n
You're going to a VISITED room.

You are in Dungeon Entrance
The number of viable directions is 1.

Exits: south (Luminous Gardens)

>s
You're going to a VISITED room.

You are in Luminous Gardens
The number of viable directions is 2.

Exits: north (Dungeon Entrance) or east (Den of Darkness)

>e
You're going to a VISITED room.

You are in Den of Darkness
The number of viable directions is 2.

Exits: east (Jewelled Forest) or west (Luminous Gardens)

>e
You're going to a VISITED room.

You are in Jewelled Forest
The number of viable directions is 2.

Exits: east (Evil Archives) or west (Den of Darkness)

>e
You are in Evil Archives
The number of viable directions is 1.
You are in Evil Archives for the FIRST time
~~~~ next room will be Hall of Time
available directions: north, south, east, west and down
removing west because you just came from there 
~~~~ next direction will be north

Evil Archives
Row upon row of moldering tomes, dust, and a sense of forboding fill this underground library.

You can see a spider here.

Exits: north (Hall of Time) or west (Jewelled Forest)

>n
You are in the Hall of Time
The number of viable directions is 1.
You are in the Hall of Time for the FIRST time
~~~~ next room will be Nasty Passage
available directions: north, south, east, west and down
removing south because you just came from there 
~~~~ next direction will be north

Hall of Time
A long, narrow hall, flickering with light from magefire sconces. The painted walls show the progression of time through planets and stars, sun and moons.

Exits: north (Nasty Passage) or south (Evil Archives)

>n
You are in Nasty Passage
The number of viable directions is 1.
You are in Nasty Passage for the FIRST time
~~~~ next room will be Disturbing Hallway
available directions: north, south, east, west and down
removing south because you just came from there 
~~~~ next direction will be east

Nasty Passage
A tight squeeze between damp and slimy boulders. There is blood on the ground.

Exits: south (Hall of Time) or east (Disturbing Hallway)

>e
You are in Disturbing Hallway
The number of viable directions is 1.
You are in Disturbing Hallway for the FIRST time
~~~~ next room will be Marble Halls
available directions: north, south, east, west and down
removing west because you just came from there 
~~~~ next direction will be down

Disturbing Hallway
The angles here, the colors, the feel of the air -- just wrong. Horribly wrong.

You can see a gelatinous cube here.

Exits: west (Nasty Passage) or down (Marble Halls)

>d
You are in Marble Halls
The number of viable directions is 1.
You are in Marble Halls for the FIRST time
~~~~ next room will be Glittering Shrine
available directions: north, south, east, west and down
~~~~ next direction will be down

Marble Halls
White flowstone gleams in thick curtains on the walls of this magnificent hall.

Exits: up (Disturbing Hallway) or down (Glittering Shrine)

>d
You are in Glittering Shrine
The number of viable directions is 1.
You are in Glittering Shrine for the FIRST time
~~~~ next room will be Webby Corridor
available directions: north, south, east, west and down
~~~~ next direction will be south

Glittering Shrine
Flecks of shining mica gleam from granite walls.

You can see an obsidian altar here.

Exits: south (Webby Corridor) or up (Marble Halls)

>s
You are in Webby Corridor
The number of viable directions is 1.
You are in Webby Corridor for the FIRST time
~~~~ next room will be Chilly Mausoleum
available directions: north, south, east, west and down
removing north because you just came from there 
~~~~ next direction will be down

Webby Corridor
Dusty ropes of thick spiderweb festoon the walls.

Exits: north (Glittering Shrine) or down (Chilly Mausoleum)

>d
You are in Chilly Mausoleum
The number of viable directions is 1.
You are in Chilly Mausoleum for the FIRST time
~~~~ next room will be Uncanny Lair
available directions: north, south, east, west and down
~~~~ next direction will be down

Chilly Mausoleum
Cold seeps into your bones. Faceless tombs loom overhead.

You can see a lumbering mummy here.

Exits: up (Webby Corridor) or down (Uncanny Lair)

>d
You are in Uncanny Lair
The number of viable directions is 1.
You are in Uncanny Lair for the FIRST time
~~~~ next room will be Waterfall Cave
available directions: north, south, east, west and down
~~~~ next direction will be east

Uncanny Lair
Oddly shaped bones are strewn about this rough cave. Some creature made a nest in one corner out of shredded fungus.

Exits: east (Waterfall Cave) or up (Chilly Mausoleum)

>e
You are in Waterfall Cave
The number of viable directions is 1.
You are in Waterfall Cave for the FIRST time
~~~~ next room will be Chamber of Lights
available directions: north, south, east, west and down
removing west because you just came from there 
~~~~ next direction will be south

Waterfall Cave
Water pours down from high above, catching on stalactites and glinting in the eerie glow from the walls. A little pool lies underneath.

Exits: south (Chamber of Lights) or west (Uncanny Lair)

>s
You are in Chamber of Lights
The number of viable directions is 1.
You are in Chamber of Lights for the FIRST time
~~~~ next room will be Rockslide Cavern
available directions: north, south, east, west and down
removing north because you just came from there 
~~~~ next direction will be east

Chamber of Lights
An uncanny mottled glow emanates from the walls of this high-ceilinged cavern.

You can see a grumpy kobold here.

Exits: north (Waterfall Cave) or east (Rockslide Cavern)

>e
You are in Rockslide Cavern
The number of viable directions is 1.
You are in Rockslide Cavern for the FIRST time
You have reached a dead end.
Something stirs in the darkness.

Exits: west (Chamber of Lights)

>l
Rockslide Cavern
Boulders have tumbled down on one side of this cave. It's a tight squeeze to get by them.

You can see a rainbow dragon here.

Exits: west (Chamber of Lights)

>peck dragon
You sidle up to the dragon and give it a little nudge.
The dragon wakes up. It yawns hugely.

Exits: west (Chamber of Lights)

>peck dragon
You stretch out your neck to attack the dragon, then reconsider.
The dragon looks at you.

Exits: west (Chamber of Lights)

>w
You're going to a VISITED room.

You are in Chamber of Lights
The number of viable directions is 2.

Exits: north (Waterfall Cave) or east (Rockslide Cavern)

>n
You're going to a VISITED room.

You are in Waterfall Cave
The number of viable directions is 2.

Exits: south (Chamber of Lights) or west (Uncanny Lair)

>w
You're going to a VISITED room.

You are in Uncanny Lair
The number of viable directions is 2.

Exits: east (Waterfall Cave) or up (Chilly Mausoleum)

>up
You're going to a VISITED room.

You are in Chilly Mausoleum
The number of viable directions is 2.

Exits: up (Webby Corridor) or down (Uncanny Lair)

>up
You're going to a VISITED room.

You are in Webby Corridor
The number of viable directions is 2.

Exits: north (Glittering Shrine) or down (Chilly Mausoleum)

>n
You're going to a VISITED room.

You are in Glittering Shrine
The number of viable directions is 2.

Exits: south (Webby Corridor) or up (Marble Halls)

>up
You're going to a VISITED room.

You are in Marble Halls
The number of viable directions is 2.

Exits: up (Disturbing Hallway) or down (Glittering Shrine)

>up
You're going to a VISITED room.

You are in Disturbing Hallway
The number of viable directions is 2.

Exits: west (Nasty Passage) or down (Marble Halls)

>w
You're going to a VISITED room.

You are in Nasty Passage
The number of viable directions is 2.

Exits: south (Hall of Time) or east (Disturbing Hallway)

>l
Nasty Passage
A tight squeeze between damp and slimy boulders. There is blood on the ground.

Exits: south (Hall of Time) or east (Disturbing Hallway)

* * *

>e
You are in Den of Darkness
The number of viable directions is 1.
You are in Den of Darkness for the FIRST time
~~~~ next room will be Jewelled Forest
available directions: north, south, east, west and down
removing west because you just came from there 
~~~~ next direction will be east

Den of Darkness
The darkness softens, the room is hushed. It's hard to see your way out.

Exits: east (Jewelled Forest) or west (Luminous Gardens)

>w
You're going to a VISITED room.

You are in Rockslide Cavern

Exits: north (Dungeon Entrance) or east (Chilly Mausoleum)

>e
You're going to a VISITED room.

You are in Chilly Mausoleum

Exits: north (Marble Halls) or west (Rockslide Cavern)

>n
You are in Marble Halls
You are in Marble Halls for the FIRST time
The number of viable directions is 1.
~~~~ next room will be Nasty Passage
available directions: north, south, east, west and down
removing south because you just came from there 
~~~~ next direction will be west

Marble Halls
White flowstone gleams in thick curtains on the walls of this magnificent hall.

Exits: south (Chilly Mausoleum) or west (Nasty Passage)

>s
You're going to a VISITED room.

You are in Chilly Mausoleum

Exits: north (Marble Halls) or west (Rockslide Cavern)

* * *

>s
You are in Luminous Gardens
The number of viable directions is 1.
You are in Luminous Gardens for the FIRST time
~~~~ next room will be Den of Darkness
available directions: north, south, east, west and down
removing north because you just came from there 
~~~~ next direction will be east

Luminous Gardens
Mushrooms the size of trees, glowing, are scattered among winding paths. Tiny lightning bugs flit between snow-pale cave blossoms.

Exits: north (Dungeon Entrance) or east (Den of Darkness)

>l
Dungeon Entrance
Stone walls, mildewed with glowing stuff, widen into a large bare room.

* * *

>s
You are in Luminous Gardens
The number of viable directions is 1.
You are in Luminous Gardens for the FIRST time
~~~~ next room will be Den of Darkness
available directions: north, south, east, west and down
removing north because you just came from there 
~~~~ next direction will be east

Luminous Gardens
Mushrooms the size of trees, glowing, are scattered among winding paths. Tiny lightning bugs flit between snow-pale cave blossoms.

Exits: north (Dungeon Entrance) or east (Den of Darkness)

>n
Unvisted: Jewelled Forest, Cavern of the Lake of Tears, Shorehaven, Evil Archives, Librarian's Lair, Glittering Shrine, Vault of Secrets, Webby Corridor, Chamber of Lights, Disturbing Hallway, Waterfall Cave, Marble Halls, Rockslide Cavern, Uncanny Lair, Den of Darkness, Luminous Gardens, Nasty Passage, Hall of Time and Vault of Vastness.
You are in Dungeon EntranceYou are in Dungeon Entrance for the FIRST time.
Unpicked: Jewelled Forest, Evil Archives, Glittering Shrine, Webby Corridor, Chamber of Lights, Disturbing Hallway, Waterfall Cave, Marble Halls, Rockslide Cavern, Uncanny Lair, Den of Darkness, Luminous Gardens, Nasty Passage and Hall of Time.
~~~~ next room will be Luminous Gardens
available directions: north, south, east, west and down
available directions: north, south, east, west and down
~~~~ next direction will be down

Dungeon Entrance
Stone walls, mildewed with glowing stuff, widen into a large bare room.

You can see a tentacled horror, a giant rat and a trophy case (empty) here.

Exits: south (Chilly Mausoleum) or down (Luminous Gardens)

* * *

>s
You are in Luminous Gardens
The number of viable directions is 1.
You are in Luminous Gardens for the FIRST time
~~~~ next room will be Den of Darkness
available directions: north, south, east, west and down
removing north because you just came from there 
~~~~ next direction will be east

Luminous Gardens
Mushrooms the size of trees, glowing, are scattered among winding paths. Tiny lightning bugs flit between snow-pale cave blossoms.

Exits: north (Dungeon Entrance) or east (Den of Darkness)

>swim
Waterfall Pool isn't wet enough.

Exits: north (Dungeon Entrance) or south (Den of Darkness)

* * *

>s
You are in Luminous Gardens
The number of viable directions is 1.
You are in Luminous Gardens for the FIRST time
~~~~ next room will be Den of Darkness
available directions: north, south, east, west and down
removing north because you just came from there 
~~~~ next direction will be east

Luminous Gardens
Mushrooms the size of trees, glowing, are scattered among winding paths. Tiny lightning bugs flit between snow-pale cave blossoms.

Exits: north (Dungeon Entrance) or east (Den of Darkness)

>w
Unpicked: Evil Archives, Glittering Shrine, Webby Corridor, Chamber of Lights, Disturbing Hallway, Waterfall Cave, Marble Halls, Rockslide Cavern, Uncanny Lair, Den of Darkness, Luminous Gardens, Nasty Passage, Vault of Vastness, Chilly Mausoleum and Hall of Time.

Cavern of the Lake of Tears
A still, deep lake stretches into the distance. It's vast. You can't see the other side.

Exits: south (Webby Corridor) or east (Jewelled Forest)

>d
Webby Corridor
Dusty ropes of thick spiderweb festoon the walls.

Exits: up (Nasty Passage) or down (Luminous Gardens)

>d
Luminous Gardens
Exits: up (Webby Corridor) or down (Chamber of Lights)

>d
Chamber of Lights
An uncanny mottled glow emanates from the walls of this high-ceilinged cavern.

Exits: west (Disturbing Hallway) or up (Luminous Gardens)

>w
You have reached a dead end.
Something stirs in the darkness.

Exits: east (Chamber of Lights)

>l
Disturbing Hallway
The angles here, the colors, the feel of the air -- just wrong. Horribly wrong.

You can see a sleeping dragon here.

Exits: east (Chamber of Lights)

* * *

>w
Unpicked: Evil Archives, Glittering Shrine, Webby Corridor, Chamber of Lights, Disturbing Hallway, Waterfall Cave, Marble Halls, Rockslide Cavern, Uncanny Lair, Den of Darkness, Luminous Gardens, Nasty Passage, Vault of Vastness, Chilly Mausoleum and Hall of Time.

Cavern of the Lake of Tears
A still, deep lake stretches into the distance. It's vast. You can't see the other side.

Exits: south (Webby Corridor) or east (Jewelled Forest)

>exits
You can go east or west from here.

Exits: east or west

* * *

>w
Unpicked: Evil Archives, Glittering Shrine, Webby Corridor, Chamber of Lights, Disturbing Hallway, Waterfall Cave, Marble Halls, Rockslide Cavern, Uncanny Lair, Den of Darkness, Luminous Gardens, Nasty Passage, Vault of Vastness, Chilly Mausoleum and Hall of Time.

Cavern of the Lake of Tears
A still, deep lake stretches into the distance. It's vast. You can't see the other side.

Exits: south (Webby Corridor) or east (Jewelled Forest)

>swim
The water feels great!
Ominous, like a grim battleship, you glide across the crystal waters.
You notice a little beach to the west.

Exits: south (Webby Corridor) or east (Jewelled Forest) or west (Shorehaven)

>w
You get out of the water.
Unpicked: Evil Archives, Glittering Shrine, Webby Corridor, Chamber of Lights, Disturbing Hallway, Waterfall Cave, Marble Halls, Rockslide Cavern, Uncanny Lair, Den of Darkness, Luminous Gardens, Nasty Passage, Vault of Vastness, Chilly Mausoleum and Hall of Time.

Shorehaven
A peaceful, secluded little beach, just the right size for a dungeon-going goose. A good place to tuck your head under your wing for a short nap.

You can see a spider here.

Exits: east (Cavern of the Lake of Tears) or west (Glittering Shrine)

>e
Unpicked: Evil Archives, Glittering Shrine, Webby Corridor, Chamber of Lights, Disturbing Hallway, Waterfall Cave, Marble Halls, Rockslide Cavern, Uncanny Lair, Den of Darkness, Luminous Gardens, Nasty Passage, Vault of Vastness, Chilly Mausoleum and Hall of Time.

Cavern of the Lake of Tears
A still, deep lake stretches into the distance. It's vast. You can't see the other side.

You can see a lumbering mummy here.

Exits: south (Webby Corridor) or east (Jewelled Forest) or west (Marble Halls)

>s
Unpicked: Evil Archives, Glittering Shrine, Chamber of Lights, Disturbing Hallway, Waterfall Cave, Marble Halls, Rockslide Cavern, Uncanny Lair, Den of Darkness, Luminous Gardens, Nasty Passage, Vault of Vastness, Chilly Mausoleum and Hall of Time.

Webby Corridor
Dusty ropes of thick spiderweb festoon the walls.

You can see a gelatinous cube here.

Exits: north (Cavern of the Lake of Tears) or west (Luminous Gardens)

* * *

>d
You waddle valiantly forth.

The walls rumble. Rocks fall.
You can't see the sky anymore!
There is no way out.

Dungeon Entrance
Stone walls, mildewed with glowing stuff, widen into a large cold room. 

A large, colorful sign is on the wall.

You can see a healing potion and a trophy case (closed) here.

Exits: east (Rockslide Cavern)

>se
Webby Corridor

>exits
You can go  from here.

>nw
You can't go that way.

* * *

>d
You waddle valiantly forth.

The walls rumble. Rocks fall.
You can't see the sky anymore!
There is no way out.

Dungeon Entrance
Stone walls, mildewed with glowing stuff, widen into a large cold room. 

A large, colorful sign is on the wall.

You can see a healing potion and a trophy case (closed) here.

Exits: east (Rockslide Cavern)

>showme
Dungeon Entrance - room
    yourself - person

>actions
Actions listing on.

>n
[going north]
You can't go that way.
[going north - failed the can't go that way rule]

>s
[going south]
You can't go that way.
[going south - failed the can't go that way rule]

>d
[going down]
You can't go that way.
[going down - failed the can't go that way rule]

>l
[looking]
Dungeon Entrance
[looking - succeeded]

>u
[going up]

Magnificent ruins
[going up - succeeded]

>d
[going down]

Dungeon Entrance
[going down - succeeded]

* * *

>d
You waddle valiantly forth.

The walls rumble. Rocks fall.
You can't see the sky anymore!
There is no way out.

Dungeon Entrance
Stone walls, mildewed with glowing stuff, widen into a large cold room. 

A large, colorful sign is on the wall.

You can see a healing potion and a trophy case (closed) here.

Exits: east (Rockslide Cavern)

>sw
You're going to a new room.

Disturbing Hallway

>exit
But you aren't in anything at the moment.

>exits
You can go northeast (Dungeon Entrance) from here.

* * *

>sw
You're going to a new room.

Disturbing Hallway

>l
Lake of Tears

>exits
You can go northeast (Dungeon Entrance) from here.

>ne
Dungeon Entrance
Stone walls, mildewed with glowing stuff, widen into a large bare room.

>ls
That's not a verb I recognise.

>look
Dungeon Entrance
Stone walls, mildewed with glowing stuff, widen into a large bare room.

>exits
You can go southwest (Lake of Tears) from here.

>sw
Lake of Tears

>l
Lake of Tears

* * *

>d
You waddle valiantly forth.

The walls rumble. Rocks fall.
You can't see the sky anymore!
There is no way out.

Dungeon Entrance
Stone walls, mildewed with glowing stuff, widen into a large cold room. 

A large, colorful sign is on the wall.

You can see a healing potion and a trophy case (closed) here.

Exits: east (Rockslide Cavern)

>take mail
You can't see any such thing.

>take platemail
Taken.

Exits: west (Glittering Shrine)

>wear all
(AirDnD platemail)
Exits: west (Glittering Shrine)

>i
You are carrying: 
  AirDnD platemail (worn on body)

Exits: west (Glittering Shrine)

>l
Dungeon Entrance
Stone walls, mildewed with glowing stuff, widen into a large cold room. 

A large, colorful sign is on the wall.

You can see an iridium bat and a trophy case (empty) here.

Exits: west (Glittering Shrine)

>look bat
It looks fierce and fangy.

Exits: west (Glittering Shrine)

>kill bat
You viciously peck the iridium bat, causing 6 points of damage!
You viciously peck the iridium bat, causing 5 points of damage!

The iridium bat attacks you, causing 3 points of damage!

Exits: west (Glittering Shrine)

>kill bat
You viciously peck the iridium bat, causing 5 points of damage!

The iridium bat leaps back in shock.
"Ow, that's going too far!" it yells.
The iridium bat drags itself off into the darkness.

Exits: west (Glittering Shrine)

[Your score has just gone up by one point.]

>w
Grunting with effort, you clamber over the rocky floor.

Glittering Shrine
Flecks of shining mica gleam from granite walls.

You can see an AirDnD headlamp and an obsidian altar here.

Exits: south (Rockslide Cavern) or east (Dungeon Entrance)

>take all
AirDnD headlamp: Taken.

Exits: south (Rockslide Cavern) or east (Dungeon Entrance)

>wear headlamp
Exits: south (Rockslide Cavern) or east (Dungeon Entrance)

* * *

>d
You waddle valiantly forth.

The walls rumble. Rocks fall.
You can't see the sky anymore!
There is no way out.

Dungeon Entrance
Stone walls, mildewed with glowing stuff, widen into a large cold room. 

A large, colorful sign is on the wall.

You can see a healing potion and a trophy case (closed) here.

Exits: east (Rockslide Cavern)

>take potion
Taken.

Exits: down (Cavern of the Lake of Tears)

>drink potion
There's nothing suitable to drink here.

Exits: down (Cavern of the Lake of Tears)

* * *

>take potion
Taken.

Exits: down (Cavern of the Lake of Tears)

>peck kobold
You viciously peck the grumpy kobold, causing 5 points of damage!
You viciously peck the grumpy kobold, causing 4 points of damage!

The grumpy kobold attacks you, causing 2 points of damage!

Exits: west (Luminous Gardens)

>stats
Strength: 3   Ferocity: 2   HP: 8/10 

Exits: west (Luminous Gardens)

>eat potion
Exits: west (Luminous Gardens)

>stats
Strength: 3   Ferocity: 2   HP: 11/10 

Exits: west (Luminous Gardens)

* * *

>d
You waddle valiantly forth.

The walls rumble. Rocks fall.
You can't see the sky anymore!
There is no way out.

Dungeon Entrance
Stone walls, mildewed with glowing stuff, widen into a large cold room. 

A large, colorful sign is on the wall.

You can see a healing potion and a trophy case (closed) here.

Exits: east (Rockslide Cavern)

>take tiara
Taken.

Exits: north (Luminous Gardens)

>wear tiara
You put on the diamond tiara.

Exits: north (Luminous Gardens)

>i
You are carrying:
  a diamond tiara (being worn)

Exits: north (Luminous Gardens)

>eq
You are wearing: 
  a diamond tiara

Exits: east (Den of Darkness)

* * *

>i
You are carrying:
  a diamond tiara (being worn)

Exits: north (Luminous Gardens)

>remove tiara
You take off the diamond tiara.

Exits: east (Chilly Mausoleum)

>put tiara in case
You put the diamond tiara into the trophy case.

Exits: east (Chilly Mausoleum)

>l
Dungeon Entrance
Stone walls, mildewed with glowing stuff, widen into a large bare room.

You can see a giant rat and a trophy case (in which is a diamond tiara) here.

Exits: east (Chilly Mausoleum)

>peck rat
You viciously peck the giant rat, causing 5 points of damage!
You viciously peck the giant rat, causing 3 points of damage!

The giant rat falls over, gasping in pain.
"Level 1 humans only, that's what they promised," it whines, cringing.
It drags itself off into the darkness.

Exits: east (Chilly Mausoleum)

>e
Chilly Mausoleum
Cold seeps into your bones. Faceless tombs loom overhead.

Exits: north (Rockslide Cavern) or west (Dungeon Entrance)

>n
Rockslide Cavern
Boulders have tumbled down on one side of this cave. It's a tight squeeze to get by them.

You can see a confused adventurer here.

Exits: south (Chilly Mausoleum) or down (Waterfall Cave)

>peck adventurer
You viciously peck the confused adventurer, causing 3 points of damage!
You viciously peck the confused adventurer, causing 6 points of damage!

The confused adventurer attacks you, causing 3 points of damage!

Exits: south (Chilly Mausoleum) or down (Waterfall Cave)

>peck adventurer
You viciously peck the confused adventurer, causing 10 points of damage!
You viciously peck the confused adventurer, causing 6 points of damage!

The confused adventurer attacks you, causing 2 points of damage!

Exits: south (Chilly Mausoleum) or down (Waterfall Cave)

>peck adventurer
You viciously peck the confused adventurer, causing 9 points of damage!

The confused adventurer falls over, gasping in pain.
"What ARE you?" it yells.
It drags itself off into the darkness.

Exits: south (Chilly Mausoleum) or down (Waterfall Cave)

>d
Waterfall Cave
Water pours down from high above, catching on stalactites and glinting in the eerie glow from the walls. A little pool lies underneath.

Exits: east (Hall of Time) or up (Rockslide Cavern)

>e
Hall of Time
A long, narrow hall, flickering with light from magefire sconces. The painted walls show the progression of time through planets and stars, sun and moons.

You can see a spider here.

Exits: south (Luminous Gardens) or west (Waterfall Cave)

>s
Luminous Gardens
Mushrooms the size of trees, glowing, are scattered among winding paths. Tiny lightning bugs flit between snow-pale cave blossoms.

Exits: north (Hall of Time) or south (Den of Darkness)

>s
Den of Darkness
The darkness softens, the room is hushed. It's hard to see your way out.

You can see a wispy ghost here.

Exits: north (Luminous Gardens) or east (Evil Archives)

>e
Evil Archives
Row upon row of moldering tomes, dust, and a sense of forboding fill this underground library.

You can see a tentacled horror here.

Exits: west (Den of Darkness) or down (Chamber of Lights)

>stats
Strength: 3   Ferocity: 2 

Exits: west (Den of Darkness) or down (Chamber of Lights)

* * *

>i
You are carrying:
  a diamond tiara (being worn)

Exits: north (Luminous Gardens)

>take lanyard
Taken.

Exits: north (Luminous Gardens)

>wear lanyard
You put on the AirDnD lanyard.

Exits: north (Luminous Gardens)

>i
You are carrying:
  an AirDnD lanyard (being worn)
  a diamond tiara (being worn)

Exits: north (Luminous Gardens)

>equip
You are wearing: 
  an AirDnD lanyard
  a diamond tiara

Exits: north (Luminous Gardens)

* * *

>d
You waddle valiantly forth.

The walls rumble. Rocks fall.
You can't see the sky anymore!
There is no way out.

Dungeon Entrance
Stone walls, mildewed with glowing stuff, widen into a large cold room. 

A large, colorful sign is on the wall.

You can see a healing potion and a trophy case (closed) here.

Exits: east (Rockslide Cavern)

>take vial
Taken.

worn: Exits: south (Jewelled Forest)

>s
removing north because you just came from there 

Jewelled Forest
Marvellous columns march down the length of this immense cave. Jewel-like lights shine from deep within.

You can see a confused adventurer here.

worn: Exits: north (Dungeon Entrance) or down (Chilly Mausoleum)

>d
Chilly Mausoleum
Cold seeps into your bones. Faceless tombs loom overhead. A tacky orange and green painting hangs on the wall.

You can see a vial of coffee here.

worn: Exits: up (Jewelled Forest) or down (Webby Corridor)

>take vial
Taken.

worn: Exits: up (Jewelled Forest) or down (Webby Corridor)

>d
Webby Corridor
Dusty ropes of thick spiderweb festoon the walls. A brightly colored poster peeks out from beneath the webs.

You can see an AirDnD lanyard, a healing potion and a tentacled horror here.

worn: Exits: south (Den of Darkness) or up (Chilly Mausoleum)

>take lanyard
Taken.

worn: Exits: south (Den of Darkness) or up (Chilly Mausoleum)

>wear lanyard
You put on the AirDnD lanyard.

worn: AirDnD lanyardExits: south (Den of Darkness) or up (Chilly Mausoleum)

* * *

>d
You waddle valiantly forth.

The walls rumble. Rocks fall.
You can't see the sky anymore!
There is no way out.

Dungeon Entrance
Stone walls, mildewed with glowing stuff, widen into a large cold room. 

A large, colorful sign is on the wall.

You can see a healing potion and a trophy case (closed) here.

Exits: east (Rockslide Cavern)

>up
Webby Corridor
Exits: up or down

>up
Rockslide Cavern
Exits: west or down

>w
Marble Halls
Exits: north or south or east

>s
Marble Halls
Exits: north or south or east

>n
Uncanny Lair
Exits: south or east

>e
Disturbing Hallway
Exits: east or west

>e
Disturbing Hallway
Exits: east or west or up

>e
Disturbing Hallway
Exits: east or west or up

>up
Den of Darkness
Exits: north or down

>n
Lake of Tears
Exits: south or up

>s
Den of Darkness
Exits: north or down

* * *

>d
You waddle valiantly forth.

The walls rumble. Rocks fall.
You can't see the sky anymore!
There is no way out.

Dungeon Entrance
Stone walls, mildewed with glowing stuff, widen into a large cold room. 

A large, colorful sign is on the wall.

You can see a healing potion and a trophy case (closed) here.

Exits: east (Rockslide Cavern)

>w
You are in Den of Darkness
The number of viable directions is 1.
You are in Den of Darkness for the FIRST time
~~~~ next room will be Uncanny Lair
available directions: north, south, east, west and down
removing east because you just came from there 
~~~~ next direction will be down

Den of Darkness
The darkness softens, the room is hushed. It's hard to see your way out.

You can see a confused adventurer here.

Exits: east (Dungeon Entrance) or down (Uncanny Lair)

>d
You are in Uncanny Lair
The number of viable directions is 1.
You are in Uncanny Lair for the FIRST time
~~~~ next room will be Webby Corridor
available directions: north, south, east, west and down
~~~~ next direction will be east

Uncanny Lair
Oddly shaped bones are strewn about this rough cave. Some creature made a nest in one corner out of shredded fungus.

You can see a lumbering mummy here.

Exits: east (Webby Corridor) or up (Den of Darkness)

>w
Marble Halls
White flowstone gleams in thick curtains on the walls of this magnificent hall.

Exits: north (Evil Archives) or east (Den of Darkness)

>n
Evil Archives
Exits: south (Marble Halls) or east (Chamber of Lights)

>e
Chamber of Lights
An uncanny mottled glow emanates from the walls of this high-ceilinged cavern.

Exits: east (Chilly Mausoleum) or west (Evil Archives)

>e
Chilly Mausoleum
Exits: north (Hall of Time) or west (Chamber of Lights)

>e
You can't go that way.

Exits: north (Hall of Time) or west (Chamber of Lights)

>n
Hall of Time
You can see a kobold here.

Exits: south (Chilly Mausoleum) or down (Jewelled Forest)

>d
Jewelled Forest
Exits: north (Disturbing Hallway) or west (Cavern of the Lake of Tears) or up (Hall of Time)

>w
Cavern of the Lake of Tears
A still, deep lake stretches into the distance. It's vast. You can't see the other side.

Exits: north (Rockslide Cavern) or east (Jewelled Forest)

>exits
You can go north (Rockslide Cavern) or east (Jewelled Forest) from here.

Exits: north (Rockslide Cavern) or east (Jewelled Forest)

>swim
The water feels great!
Ominous, like a grim battleship, you glide across the crystal waters.
You notice a little beach to the west.

Exits: north (Rockslide Cavern) or east (Jewelled Forest) or west (Shorehaven)

>w
You get out of the water.

Shorehaven
Exits: east (Cavern of the Lake of Tears) or west (Luminous Gardens)

* * *

>w
Marble Halls
White flowstone gleams in thick curtains on the walls of this magnificent hall.

Exits: north (Evil Archives) or east (Den of Darkness)

>w
~~~~ next room will be Lake of Tears
Cardinal directions: north, south, east, west and down
removing east because you just came from there 
~~~~ next direction will be north

Disturbing Hallway
You can see a spider here.

Exits: north or east

>n
~~~~ next room will be Uncanny Lair
Cardinal directions: north, south, east, west and down
removing south because you just came from there 
~~~~ next direction will be east

Lake of Tears
You can see a gelatinous cube here.

Exits: south or east

>e
~~~~ next room will be Den of Darkness
Cardinal directions: north, south, east, west and down
removing west because you just came from there 
~~~~ next direction will be down

Uncanny Lair
You can see a cave snake here.

Exits: west or down

>d
~~~~ next room will be Jewelled Forest
Cardinal directions: north, south, east, west and down
~~~~ next direction will be south

Den of Darkness
You can see a kobold here.

Exits: south or up

>s
~~~~ next room will be Rockslide Cavern
Cardinal directions: north, south, east, west and down
removing north because you just came from there 
~~~~ next direction will be west

Jewelled Forest
Exits: north or west

>w
~~~~ next room will be Marble Halls
Cardinal directions: north, south, east, west and down
removing east because you just came from there 
~~~~ next direction will be down

Rockslide Cavern
Exits: east or down

>d
~~~~ next room will be Chamber of Lights
Cardinal directions: north, south, east, west and down
~~~~ next direction will be west

Marble Halls
Exits: west or up

>w
~~~~ next room will be nothing
Cardinal directions: north, south, east, west and down
removing east because you just came from there 
~~~~ next direction will be west

[** Programming error: tried to find the "." of (something) **]

[** Programming error: tried to find the "." of (something) **]

Chamber of Lights
Exits: east

* * *

>w
You are in Den of Darkness
The number of viable directions is 1.
You are in Den of Darkness for the FIRST time
~~~~ next room will be Uncanny Lair
available directions: north, south, east, west and down
removing east because you just came from there 
~~~~ next direction will be down

Den of Darkness
The darkness softens, the room is hushed. It's hard to see your way out.

You can see a confused adventurer here.

Exits: east (Dungeon Entrance) or down (Uncanny Lair)

>e
You're going to a VISITED room.

Unvisted: Jewelled Forest, Cavern of the Lake of Tears, Shorehaven, Evil Archives, Librarian's Lair, Glittering Shrine, Vault of Secrets, Webby Corridor, Chamber of Lights, Disturbing Hallway, Waterfall Cave, Marble Halls, Rockslide Cavern, Den of Darkness, Luminous Gardens, Nasty Passage, Chilly Mausoleum, Hall of Time and Vault of Vastness
.
You are in Dungeon Entrance
You are in Dungeon Entrance for the FIRST time
Unpicked: Jewelled Forest, Evil Archives, Glittering Shrine, Webby Corridor, Chamber of Lights, Disturbing Hallway, Waterfall Cave, Marble Halls, Rockslide Cavern, Den of Darkness, Luminous Gardens, Nasty Passage, Chilly Mausoleum and Hall of Time.
~~~~ next room will be Webby Corridor
available directions: north, south, east, west and down
available directions: north, south, east, west and down
~~~~ next direction will be south

Dungeon Entrance
Stone walls, mildewed with glowing stuff, widen into a large bare room.

You can see a giant rat and a trophy case (empty) here.

Exits: south (Webby Corridor) or west (Uncanny Lair)

>w
Unvisted: Cavern of the Lake of Tears, Shorehaven, Evil Archives, Librarian's Lair, Glittering Shrine, Vault of Secrets, Webby Corridor, Chamber of Lights, Disturbing Hallway, Waterfall Cave, Marble Halls, Rockslide Cavern, Uncanny Lair, Den of Darkness, Luminous Gardens, Nasty Passage, Chilly Mausoleum, Hall of Time and Vault of Vastness.
You are in this room for the FIRST time.
Unpicked: Evil Archives, Glittering Shrine, Webby Corridor, Chamber of Lights, Disturbing Hallway, Waterfall Cave, Marble Halls, Rockslide Cavern, Uncanny Lair, Den of Darkness, Luminous Gardens, Nasty Passage, Chilly Mausoleum and Hall of Time.
~~~~ next room will be Evil Archives
available directions: north, south, east, west and down
removing north because you just came from there 
removing east because you just came from there 
removing west because you just came from there 
available directions: south and down
~~~~ next direction will be south

Jewelled Forest
Marvellous columns march down the length of this immense cavern. Jewel-like lights shine from deep within.

Exits: north (Uncanny Lair) or south (Evil Archives) or east (Dungeon Entrance) or west (Cavern of the Lake of Tears)

>e
Unvisted: Cavern of the Lake of Tears, Shorehaven, Evil Archives, Librarian's Lair, Glittering Shrine, Vault of Secrets, Webby Corridor, Chamber of Lights, Disturbing Hallway, Waterfall Cave, Marble Halls, Rockslide Cavern, Uncanny Lair, Den of Darkness, Luminous Gardens, Nasty Passage, Chilly Mausoleum, Hall of Time and Vault of Vastness.
You are in this room for the FIRST time.
Unpicked: Evil Archives, Glittering Shrine, Webby Corridor, Chamber of Lights, Disturbing Hallway, Waterfall Cave, Marble Halls, Rockslide Cavern, Uncanny Lair, Den of Darkness, Luminous Gardens, Nasty Passage, Chilly Mausoleum and Hall of Time.
~~~~ next room will be Evil Archives
available directions: north, south, east, west and down
available directions: north, south, east, west and down
~~~~ next direction will be east

Dungeon Entrance
Stone walls, mildewed with glowing stuff, widen into a large bare room.

You can see a confused adventurer, a giant rat and a trophy case (empty) here.

Exits: east (Evil Archives) or west (Jewelled Forest) or down (Evil Archives)

* * *

>w
You are in Den of Darkness
The number of viable directions is 1.
You are in Den of Darkness for the FIRST time
~~~~ next room will be Uncanny Lair
available directions: north, south, east, west and down
removing east because you just came from there 
~~~~ next direction will be down

Den of Darkness
The darkness softens, the room is hushed. It's hard to see your way out.

You can see a confused adventurer here.

Exits: east (Dungeon Entrance) or down (Uncanny Lair)

>n
Uncanny Lair
You can see an iridium bat here.

Exits: north (Chilly Mausoleum) or south (Crumbling Corridor)

>n
Chilly Mausoleum
You can see a wispy ghost here.

Exits: south (Uncanny Lair) or east (Vault of Vastness)

>e
Vault of Vastness
You can see a glowering elf here.

Exits: south (Glittering Shrine) or west (Chilly Mausoleum)

>s
Glittering Shrine
You can see a lumbering mummy here.

Exits: north (Vault of Vastness) or west (Jewelled Forest)

>w
Jewelled Forest
Exits: east (Glittering Shrine) or west (Cavern of the Lake of Tears) or down (Nasty Passage)

>w
Cavern of the Lake of Tears
A still, deep lake stretches into the distance. It's vast. You can't see the other side.

Exits: north (Marble Halls) or east (Jewelled Forest)

>examine pool
You can't see any such thing.

>swim
You must supply a noun.

Exits: north (Marble Halls) or east (Jewelled Forest)

>swim in lake
I only understood you as far as wanting to swim.

>swim in water
I only understood you as far as wanting to swim.

>swim lake
I only understood you as far as wanting to swim.

>actions
Actions listing on.

>swim
You must supply a noun.

Exits: north (Marble Halls) or east (Jewelled Forest)

>showme
Cavern of the Lake of Tears - room
    yourself - person
    water

>swim on water
I only understood you as far as wanting to swim.

>swim in water
I only understood you as far as wanting to swim.

* * *

>w
You are in Den of Darkness
The number of viable directions is 1.
You are in Den of Darkness for the FIRST time
~~~~ next room will be Uncanny Lair
available directions: north, south, east, west and down
removing east because you just came from there 
~~~~ next direction will be down

Den of Darkness
The darkness softens, the room is hushed. It's hard to see your way out.

You can see a confused adventurer here.

Exits: east (Dungeon Entrance) or down (Uncanny Lair)

>s
Evil Archives
Exits: north (Chamber of Lights) or west (Jewelled Forest)

>d
~~~~ next room will be Disturbing Hallway
Cardinal directions: south, west and down
~~~~ next direction will be south

Webby Corridor
Exits: south or up

* * *

>s
Evil Archives
Exits: north (Chamber of Lights) or west (Jewelled Forest)

>w
Jewelled Forest
You can see a spider here.

Exits: east (Evil Archives) or west (Cavern of the Lake of Tears) or down (Vault of Vastness)

>w
Cavern of the Lake of Tears
A still, deep lake stretches into the distance. It's vast. You can't see the other side.

Exits: north (Rockslide Cavern) or east (Jewelled Forest) or west (Shorehaven)

* * *

>w
You are in Den of Darkness
The number of viable directions is 1.
You are in Den of Darkness for the FIRST time
~~~~ next room will be Uncanny Lair
available directions: north, south, east, west and down
removing east because you just came from there 
~~~~ next direction will be down

Den of Darkness
The darkness softens, the room is hushed. It's hard to see your way out.

You can see a confused adventurer here.

Exits: east (Dungeon Entrance) or down (Uncanny Lair)

>showme
Marble Halls - room
    yourself - person

* * *

>w
You are in Den of Darkness
The number of viable directions is 1.
You are in Den of Darkness for the FIRST time
~~~~ next room will be Uncanny Lair
available directions: north, south, east, west and down
removing east because you just came from there 
~~~~ next direction will be down

Den of Darkness
The darkness softens, the room is hushed. It's hard to see your way out.

You can see a confused adventurer here.

Exits: east (Dungeon Entrance) or down (Uncanny Lair)

>w
Unvisted: Jewelled Forest, Cavern of the Lake of Tears, Shorehaven, Evil Archives, Librarian's Lair, Glittering Shrine, Vault of Secrets, Webby Corridor, Disturbing Hallway, Waterfall Cave, Marble Halls, Rockslide Cavern, Uncanny Lair, Den of Darkness, Luminous Gardens, Nasty Passage, Chilly Mausoleum, Hall of Time and Vault of Vastness.
Unpicked: Jewelled Forest, Evil Archives, Webby Corridor, Disturbing Hallway, Waterfall Cave, Marble Halls, Rockslide Cavern, Uncanny Lair, Den of Darkness, Luminous Gardens, Nasty Passage, Chilly Mausoleum and Hall of Time.
~~~~ next room will be Disturbing Hallway
available directions: north, south, east, west and down
removing east because you just came from there 
available directions: north, south, west and down
~~~~ next direction will be west

Glittering Shrine
Flecks of shining mica gleam from granite walls.

You can see a confused adventurer and an obsidian altar here.

Exits: east (Chamber of Lights) or west (Disturbing Hallway)

>n
Webby Corridor
Dusty ropes of thick spiderweb festoon the walls.

You can see a spider here.

Exits: south (Marble Halls) or down (Vault of Vastness)

>d
Vault of Vastness
You can see a wispy ghost here.

Exits: up (Webby Corridor) or down (Luminous Gardens)

>d
Luminous Gardens
You can see a lumbering mummy here.

Exits: east (Glittering Shrine) or up (Vault of Vastness)

>e
Glittering Shrine
You can see a soot sprite here.

Exits: east (Den of Darkness) or west (Luminous Gardens)

>e
Den of Darkness
You can see an iridium bat here.

Exits: west (Glittering Shrine) or down (Chilly Mausoleum)

>d
Chilly Mausoleum
Exits: south (Rockslide Cavern) or up (Den of Darkness)

>s
Rockslide Cavern
You can see a gelatinous cube here.

Exits: north (Chilly Mausoleum) or south (Disturbing Hallway)

>s
Disturbing Hallway
The angles here, the colors, the feel of the air -- just wrong. Horribly wrong.

You can see a glowering elf here.

Exits: north (Rockslide Cavern) or west (Waterfall Pool)

>w
You have reached a dead end.
Something stirs in the darkness.

Exits: east (Disturbing Hallway)

* * *

>d
Luminous Gardens
You can see a lumbering mummy here.

Exits: east (Glittering Shrine) or up (Vault of Vastness)

>n
Marble Halls
White flowstone gleams in thick curtains on the walls of this magnificent hall.

Exits: north (Vault of Vastness) or south (Jewelled Forest)

* * *

>s
Evil Archives
Exits: north (Chamber of Lights) or east (Luminous Gardens)

>d
Lake of Tears
You can see an iridium bat here.

Exits: south (Vault of Vastness) or up (Chilly Mausoleum)

>s
Vault of Vastness
Exits: north (Lake of Tears) or south (Rockslide Cavern)

>s
You have reached a dead end.

Exits: north (Vault of Vastness)

>l
Rockslide Cavern
You can see a sleeping dragon here.

Exits: north (Vault of Vastness)

* * *

>s
Evil Archives
Exits: north (Chamber of Lights) or east (Luminous Gardens)

>e
Luminous Gardens
Exits: east (Disturbing Hallway) or west (Evil Archives)

>e
Disturbing Hallway
The angles here, the colors, the feel of the air -- just wrong. Horribly wrong.

You can see an iridium bat here.

Exits: east (Nasty Passage) or west (Luminous Gardens)

>e
Nasty Passage
Exits: east (Uncanny Lair) or west (Disturbing Hallway)

>e
Uncanny Lair
Exits: south (Waterfall Cave) or west (Nasty Passage)

>s
Waterfall Cave
Water pours down from high above, catching on stalactites and glinting in the eerie glow from the walls. A little pool lies underneath.

Exits: north (Uncanny Lair) or west (Marble Halls)

>swim
You must supply a noun.

Exits: north (Uncanny Lair) or west (Marble Halls)

>swim in pool
I only understood you as far as wanting to swim.

* * *

>w
Unvisted: Jewelled Forest, Cavern of the Lake of Tears, Shorehaven, Evil Archives, Librarian's Lair, Vault of Secrets, Webby Corridor, Disturbing Hallway, Waterfall Cave, Marble Halls, Rockslide Cavern, Uncanny Lair, Den of Darkness, Luminous Gardens, Nasty Passage, Chilly Mausoleum, Hall of Time and Vault of Vastness.
Unpicked: Jewelled Forest, Evil Archives, Webby Corridor, Waterfall Cave, Marble Halls, Rockslide Cavern, Uncanny Lair, Den of Darkness, Luminous Gardens, Nasty Passage, Chilly Mausoleum and Hall of Time.
~~~~ next room will be Chilly Mausoleum
available directions: north, south, east, west and down
removing east because you just came from there 
available directions: north, south, west and down
~~~~ next direction will be north

Disturbing Hallway
The angles here, the colors, the feel of the air -- just wrong. Horribly wrong.

Exits: north (Chilly Mausoleum) or east (Glittering Shrine)

>n
Unvisted: Jewelled Forest, Cavern of the Lake of Tears, Shorehaven, Evil Archives, Librarian's Lair, Vault of Secrets, Webby Corridor, Waterfall Cave, Marble Halls, Rockslide Cavern, Uncanny Lair, Den of Darkness, Luminous Gardens, Nasty Passage, Chilly Mausoleum, Hall of Time and Vault of Vastness.
Unpicked: Jewelled Forest, Evil Archives, Webby Corridor, Waterfall Cave, Marble Halls, Rockslide Cavern, Uncanny Lair, Den of Darkness, Luminous Gardens, Nasty Passage and Hall of Time.
~~~~ next room will be Hall of Time
available directions: north, south, east, west and down
removing south because you just came from there 
available directions: north, east, west and down
~~~~ next direction will be down

Chilly Mausoleum
Cold seeps into your bones. Faceless tombs loom overhead.

You can see a spider here.

Exits: south (Disturbing Hallway) or down (Hall of Time)

>d
Unvisted: Jewelled Forest, Cavern of the Lake of Tears, Shorehaven, Evil Archives, Librarian's Lair, Vault of Secrets, Webby Corridor, Waterfall Cave, Marble Halls, Rockslide Cavern, Uncanny Lair, Den of Darkness, Luminous Gardens, Nasty Passage, Hall of Time and Vault of Vastness.
Unpicked: Jewelled Forest, Evil Archives, Webby Corridor, Waterfall Cave, Marble Halls, Rockslide Cavern, Uncanny Lair, Den of Darkness, Luminous Gardens and Nasty Passage.
~~~~ next room will be Jewelled Forest
available directions: north, south, east, west and down
available directions: north, south, east, west and down
~~~~ next direction will be north

Hall of Time
A long, narrow hall, flickering with light from magefire sconces. The painted walls show the progression of time through planets and stars, sun and moons.

You can see a glowering elf here.

Exits: north (Jewelled Forest) or up (Chilly Mausoleum)

>peck elf
You viciously peck the glowering elf, causing 6 points of damage!
You viciously peck the glowering elf, causing 8 points of damage!

The glowering elf attacks you, causing 3 points of damage!
The glowering elf attacks you, causing 5 points of damage!

Exits: north (Jewelled Forest) or up (Chilly Mausoleum)

>peck elf
You viciously peck the glowering elf, causing 6 points of damage!
You viciously peck the glowering elf, causing 3 points of damage!

The glowering elf attacks you, causing 5 points of damage!

You swoon.
The world shimmers and whirls.
You wake up nestled into a hollow of warm sand.
You feel completely healed after your nap.

Shorehaven
A peaceful, secluded little beach, just the right size for a dungeon-going goose. A good place to tuck your head under your wing for a short nap.

Exits: east (Cavern of the Lake of Tears)

>e
Unvisted: Jewelled Forest, Cavern of the Lake of Tears, Evil Archives, Librarian's Lair, Vault of Secrets, Webby Corridor, Waterfall Cave, Marble Halls, Rockslide Cavern, Uncanny Lair, Den of Darkness, Luminous Gardens, Nasty Passage and Vault of Vastness.
Unpicked: Jewelled Forest, Evil Archives, Webby Corridor, Waterfall Cave, Marble Halls, Rockslide Cavern, Uncanny Lair, Den of Darkness, Luminous Gardens and Nasty Passage.
~~~~ next room will be Jewelled Forest
available directions: north, south, east, west and down
removing east because you just came from there 
available directions: north, south, west and down
~~~~ next direction will be down

Cavern of the Lake of Tears
A still, deep lake stretches into the distance. It's vast. You can't see the other side.

Exits: east (Jewelled Forest) or down (Jewelled Forest)

>e
Unvisted: Jewelled Forest, Evil Archives, Librarian's Lair, Vault of Secrets, Webby Corridor, Waterfall Cave, Marble Halls, Rockslide Cavern, Uncanny Lair, Den of Darkness, Luminous Gardens, Nasty Passage and Vault of Vastness.
Unpicked: Evil Archives, Webby Corridor, Waterfall Cave, Marble Halls, Rockslide Cavern, Uncanny Lair, Den of Darkness, Luminous Gardens and Nasty Passage.
~~~~ next room will be Rockslide Cavern
available directions: north, south, east, west and down
removing south because you just came from there 
removing west because you just came from there 
available directions: north, east and down
~~~~ next direction will be east

Jewelled Forest
Marvellous columns march down the length of this immense cavern. Jewel-like lights shine from deep within.

You can see a wispy ghost here.

Exits: south (Hall of Time) or east (Rockslide Cavern) or west (Cavern of the Lake of Tears) or up (Cavern of the Lake of Tears)

>w
Unvisted: Evil Archives, Librarian's Lair, Vault of Secrets, Webby Corridor, Waterfall Cave, Marble Halls, Rockslide Cavern, Uncanny Lair, Den of Darkness, Luminous Gardens, Nasty Passage and Vault of Vastness.
Unpicked: Evil Archives, Webby Corridor, Waterfall Cave, Marble Halls, Rockslide Cavern, Uncanny Lair, Den of Darkness, Luminous Gardens and Nasty Passage.
~~~~ next room will be Waterfall Cave
available directions: north, south, east, west and down
removing east because you just came from there 
removing down because you just came from there 
available directions: north, south and west
~~~~ next direction will be south

Cavern of the Lake of Tears
A still, deep lake stretches into the distance. It's vast. You can't see the other side.

You can see a cave snake here.

Exits: south (Waterfall Cave) or east (Jewelled Forest) or down (Jewelled Forest)

>s
Unvisted: Evil Archives, Librarian's Lair, Vault of Secrets, Webby Corridor, Waterfall Cave, Marble Halls, Rockslide Cavern, Uncanny Lair, Den of Darkness, Luminous Gardens, Nasty Passage and Vault of Vastness.
Unpicked: Evil Archives, Webby Corridor, Marble Halls, Rockslide Cavern, Uncanny Lair, Den of Darkness, Luminous Gardens and Nasty Passage.
~~~~ next room will be Uncanny Lair
available directions: north, south, east, west and down
removing north because you just came from there 
available directions: south, east, west and down
~~~~ next direction will be west

Waterfall Cave
Water pours down from high above, catching on stalactites and glinting in the eerie glow from the walls. A little pool lies underneath.

Exits: north (Cavern of the Lake of Tears) or west (Uncanny Lair)

>n
Unvisted: Evil Archives, Librarian's Lair, Vault of Secrets, Webby Corridor, Marble Halls, Rockslide Cavern, Uncanny Lair, Den of Darkness, Luminous Gardens, Nasty Passage and Vault of Vastness.
Unpicked: Evil Archives, Webby Corridor, Marble Halls, Rockslide Cavern, Uncanny Lair, Den of Darkness, Luminous Gardens and Nasty Passage.
~~~~ next room will be Rockslide Cavern
available directions: north, south, east, west and down
removing south because you just came from there 
removing east because you just came from there 
removing down because you just came from there 
available directions: north and west
~~~~ next direction will be west

Cavern of the Lake of Tears
A still, deep lake stretches into the distance. It's vast. You can't see the other side.

You can see a cave snake here.

Exits: south (Waterfall Cave) or east (Jewelled Forest) or west (Rockslide Cavern) or down (Jewelled Forest)

>e
Unvisted: Evil Archives, Librarian's Lair, Vault of Secrets, Webby Corridor, Marble Halls, Rockslide Cavern, Uncanny Lair, Den of Darkness, Luminous Gardens, Nasty Passage and Vault of Vastness.
Unpicked: Evil Archives, Webby Corridor, Marble Halls, Rockslide Cavern, Uncanny Lair, Den of Darkness, Luminous Gardens and Nasty Passage.
~~~~ next room will be Nasty Passage
available directions: north, south, east, west and down
removing south because you just came from there 
removing east because you just came from there 
removing west because you just came from there 
available directions: north and down
~~~~ next direction will be down

Jewelled Forest
Marvellous columns march down the length of this immense cavern. Jewel-like lights shine from deep within.

You can see an iridium bat and a wispy ghost here.

Exits: south (Hall of Time) or east (Rockslide Cavern) or west (Cavern of the Lake of Tears) or up (Cavern of the Lake of Tears) or down (Nasty Passage)

>d
Unvisted: Evil Archives, Librarian's Lair, Vault of Secrets, Webby Corridor, Marble Halls, Rockslide Cavern, Uncanny Lair, Den of Darkness, Luminous Gardens, Nasty Passage and Vault of Vastness.
Unpicked: Evil Archives, Webby Corridor, Marble Halls, Rockslide Cavern, Uncanny Lair, Den of Darkness and Luminous Gardens.
~~~~ next room will be Webby Corridor
available directions: north, south, east, west and down
available directions: north, south, east, west and down
~~~~ next direction will be south

Nasty Passage
A tight squeeze between damp and slimy boulders. There is blood on the ground.

You can see a gelatinous cube here.

Exits: south (Webby Corridor) or up (Jewelled Forest)

>s
Unvisted: Evil Archives, Librarian's Lair, Vault of Secrets, Webby Corridor, Marble Halls, Rockslide Cavern, Uncanny Lair, Den of Darkness, Luminous Gardens and Vault of Vastness.
Unpicked: Evil Archives, Marble Halls, Rockslide Cavern, Uncanny Lair, Den of Darkness and Luminous Gardens.
~~~~ next room will be Den of Darkness
available directions: north, south, east, west and down
removing north because you just came from there 
available directions: south, east, west and down
~~~~ next direction will be east

Webby Corridor
Dusty ropes of thick spiderweb festoon the walls.

Exits: north (Nasty Passage) or east (Den of Darkness)

>e
Unvisted: Evil Archives, Librarian's Lair, Vault of Secrets, Marble Halls, Rockslide Cavern, Uncanny Lair, Den of Darkness, Luminous Gardens and Vault of Vastness.
Unpicked: Evil Archives, Marble Halls, Rockslide Cavern, Uncanny Lair and Luminous Gardens.
~~~~ next room will be Uncanny Lair
available directions: north, south, east, west and down
removing west because you just came from there 
available directions: north, south, east and down
~~~~ next direction will be east

Den of Darkness
The darkness softens, the room is hushed. It's hard to see your way out.

Exits: east (Uncanny Lair) or west (Webby Corridor)

>e
Unvisted: Evil Archives, Librarian's Lair, Vault of Secrets, Marble Halls, Rockslide Cavern, Uncanny Lair, Luminous Gardens and Vault of Vastness.
Unpicked: Evil Archives, Marble Halls, Rockslide Cavern and Luminous Gardens.
~~~~ next room will be Rockslide Cavern
available directions: north, south, east, west and down
removing east because you just came from there 
removing west because you just came from there 
available directions: north, south and down
~~~~ next direction will be down

Uncanny Lair
Oddly shaped bones are strewn about this rough cave. Some creature made a nest in one corner out of shredded fungus.

Exits: east (Waterfall Cave) or west (Den of Darkness) or down (Rockslide Cavern)

* * *

>d
You waddle valiantly forth.

The walls rumble. Rocks fall.
You can't see the sky anymore!
There is no way out.

Dungeon Entrance
Stone walls, mildewed with glowing stuff, widen into a large cold room. 

A large, colorful sign is on the wall.

You can see a healing potion and a trophy case (closed) here.

Exits: east (Rockslide Cavern)

>x sign
A glossy sign in bright orange and virulent green, with a stylized picture of a sword on a pile of money. It says, "Welcome to your new Dungeon Away From Home! Let AirDnD be your Guide, as we bring you to new depths in Adventuring!

Exits: east (Hall of Time)

>help
Here's some basic commands you can use in play.

You can "go" in all 8 directions (north, northeast, etc) as well as up and down. 
 You can also take things, open things, sit on things, and stand up. "take all" will pick up everything possible in a room.

 look: shows you the description of the room you're in 
 i:  lists what you are carrying or wearing. Short for "inventory"  
 n: short for "go north" 
 x: lets you examine something more closely 
 x self: look at yourself 
 honk, peck, flap, kill: Try them and see what happens! 
 wear: put on a wearable object 
 stats: shows your current strength, ferocity, and hit points
 score: shows your current score 

Exits: east (Hall of Time)

>e
Hissing a little, you peer from side to side.

removing west because you just came from there 

Hall of Time
A long, narrow hall, flickering with light from magefire sconces. The painted walls show the progression of time through planets and stars, sun and moons.

You can see a soot sprite here.

Exits: west (Dungeon Entrance) or down (Den of Darkness)

>peck sprite
You viciously peck the soot sprite, causing 8 points of damage!
You viciously peck the soot sprite, causing 10 points of damage!

The soot sprite trips and falls.
"Oooh, that smarts," it shrieks, scuttling away.
The soot sprite drags itself off into the darkness.

Exits: west (Dungeon Entrance) or down (Den of Darkness)

[Your score has just gone up by one point.]

>d
Your beady-eyed glance darts across yet another corridor.

Den of Darkness
The darkness softens, the room is hushed. It's hard to see your way out.

You can see a lumbering mummy here.

Exits: south (Luminous Gardens) or up (Hall of Time)

>look mummy
It looks tattered and clumsy.

Exits: south (Luminous Gardens) or up (Hall of Time)

>peck mummy
You viciously peck the lumbering mummy, causing 9 points of damage!
You viciously peck the lumbering mummy, causing 8 points of damage!

The lumbering mummy trips and falls.
"That's it, I quit!" it yells.
The lumbering mummy drags itself off into the darkness.

Exits: south (Luminous Gardens) or up (Hall of Time)

[Your score has just gone up by one point.]

>s
Hissing a little, you peer from side to side.

removing north because you just came from there 

Luminous Gardens
Mushrooms the size of trees, glowing, are scattered among winding paths. Tiny lightning bugs flit between snow-pale cave blossoms.

You can see an AirDnD lanyard, a healing potion and a cave snake here.

Exits: north (Den of Darkness) or down (Disturbing Hallway)

>take all
AirDnD lanyard: Taken.
healing potion: Taken.

Exits: north (Den of Darkness) or down (Disturbing Hallway)

>wear lanyard
Exits: north (Den of Darkness) or down (Disturbing Hallway)

>look snake
It looks like it needs its butt kicked.

Exits: north (Den of Darkness) or down (Disturbing Hallway)

>peck snake
You viciously peck the cave snake, causing 3 points of damage!
You viciously peck the cave snake, causing 10 points of damage!

The cave snake falls over, gasping in pain.
"Ow, that's going too far!" it mutters as it turns to run.
The cave snake drags itself off into the darkness.

Exits: north (Den of Darkness) or down (Disturbing Hallway)

[Your score has just gone up by one point.]

>d
Your broad foot webs slappity-slap across the dungeon floor.

Disturbing Hallway
The angles here, the colors, the feel of the air -- just wrong. Horribly wrong.

You can see an AirDnD headlamp and a vial of coffee here.

Exits: up (Luminous Gardens) or down (Glittering Shrine)

>take all
AirDnD headlamp: Taken.
vial of coffee: Taken.

Exits: up (Luminous Gardens) or down (Glittering Shrine)

>wear all
You can't use multiple objects with that verb.

>i
You are carrying: 
  a vial of coffee
  an AirDnD headlamp
  a healing potion
  an AirDnD lanyard (worn on neck)

Exits: up (Luminous Gardens) or down (Glittering Shrine)

>wear headlamp
Exits: up (Luminous Gardens) or down (Glittering Shrine)

>stats
Strength: 4   Ferocity: 3   HP: 10/10 

Exits: up (Luminous Gardens) or down (Glittering Shrine)

>x self
You crane your long, graceful neck to look back. 
White, muscular, hefty, feathered. 
Yes, you're still a fabulous goose!

Exits: up (Luminous Gardens) or down (Glittering Shrine)

>i
You are carrying: 
  a vial of coffee
  an AirDnD headlamp (worn on head)
  a healing potion
  an AirDnD lanyard (worn on neck)

Exits: up (Luminous Gardens) or down (Glittering Shrine)

>d
You waddle valiantly forth.

Glittering Shrine
Flecks of shining mica gleam from granite walls.

You can see an iridium bat and an obsidian altar here.

Exits: north (Uncanny Lair) or up (Disturbing Hallway)

* * *

It's a beautiful day in the dungeon, and you are a horrible goose.
Thanks to Danny O'Brien and Ada Norton for playtesting.
Thanks to Eunju Beck for the cover art.

Try typing "help" for instructions on how to play.

Roguelike Goose
An Interactive Fiction by Lizzard
Release 1 / Serial number 200112 / Inform 7 build 6M62 (I6/v6.33 lib 6/12N) SD

Mysterious ruins
Stone crumbles in a blasted wasteland. Grey, twisted trees grow from crevices in the walls. A narrow staircase descends into darkness.

>down
Grunting with effort, you clamber over the rocky floor.

The walls rumble. Rocks fall.
You can't see the sky anymore!
There is no way out.

Dungeon Entrance
Stone walls, mildewed with glowing stuff, widen into a large cold room. 

A large, colorful sign is on the wall.

You can see a confused adventurer and a trophy case (empty) here.

Exits: down (Glittering Shrine)

>honk
HONK!!!!

Startled, a denizen of the dungeon looks up in alarm.

Exits: down (Glittering Shrine)

>look at adventurer
It looks battle-hardened.

Exits: down (Glittering Shrine)

>peck adventurer
You viciously peck the confused adventurer, causing 9 points of damage!
You viciously peck the confused adventurer, causing 10 points of damage!

The confused adventurer attacks you, causing 4 points of damage!

Exits: down (Glittering Shrine)

>examine trophy case
An enormous marble trophy case. The front is carved with the motto, "Vae victis"

Exits: down (Glittering Shrine)

>look
Dungeon Entrance
Stone walls, mildewed with glowing stuff, widen into a large cold room. 

A large, colorful sign is on the wall.

You can see a confused adventurer and a trophy case (empty) here.

Exits: down (Glittering Shrine)

>examine adventurer
It looks battle-hardened.

Exits: down (Glittering Shrine)

>read sign
A glossy sign in bright orange and virulent green, with a stylized picture of a sword on a pile of money. It says, "Welcome to your new Dungeon Away From Home! Let AirDnD be your Guide, as we bring you to new depths in Adventuring! *AirDnD*

Exits: down (Glittering Shrine)

>peck sign
You jab your beak at the welcome sign.

Exits: down (Glittering Shrine)

>peck adventurer
You viciously peck the confused adventurer, causing 6 points of damage!
You viciously peck the confused adventurer, causing 8 points of damage!

The confused adventurer trips and falls.
"Mama always told me never to cross a dungeon picket line," it mutters as it turns to run.
The confused adventurer drags itself off into the darkness.

Exits: down (Glittering Shrine)

[Your score has just gone up by one point.]

>look
Dungeon Entrance
Stone walls, mildewed with glowing stuff, widen into a large cold room. 

A large, colorful sign is on the wall.

You can see a trophy case (empty) here.

Exits: down (Glittering Shrine)

>examine trophy case
An enormous marble trophy case. The front is carved with the motto, "Vae victis"

Exits: down (Glittering Shrine)

>down
Hissing a little, you peer from side to side.

Glittering Shrine
Flecks of shining mica gleam from granite walls.

You can see a spider and an obsidian altar here.

Exits: east (Rockslide Cavern) or up (Dungeon Entrance)

>examine altar
A slab of black glass forms an altar along one wall. An inscription runs along its rim.

Exits: east (Rockslide Cavern) or up (Dungeon Entrance)

>read inscription
It says, in shimmering black letters, "Sphinx of black quartz, judge my vow."

Exits: east (Rockslide Cavern) or up (Dungeon Entrance)

>look
Glittering Shrine
Flecks of shining mica gleam from granite walls.

You can see a spider and an obsidian altar here.

Exits: east (Rockslide Cavern) or up (Dungeon Entrance)

>examine spider
It looks a delicious little bug.

Exits: east (Rockslide Cavern) or up (Dungeon Entrance)

>eat spider
He's plainly inedible.

Exits: east (Rockslide Cavern) or up (Dungeon Entrance)

>peck spider
You viciously peck the spider, causing 8 points of damage!
You viciously peck the spider, causing 6 points of damage!

The spider attacks you, causing 1 points of damage!

Exits: east (Rockslide Cavern) or up (Dungeon Entrance)

>peck spider
You viciously peck the spider, causing 5 points of damage!

The spider trips and falls.
"Ow, that's going too far!" it mutters as it turns to run.
The spider drags itself off into the darkness.

Exits: east (Rockslide Cavern) or up (Dungeon Entrance)

[Your score has just gone up by one point.]

>look
Glittering Shrine
Flecks of shining mica gleam from granite walls.

You can see an obsidian altar here.

Exits: east (Rockslide Cavern) or up (Dungeon Entrance)

>pray to altar
That's not a verb I recognise.

>pray altar
That's not a verb I recognise.

>worship at altar
That's not a verb I recognise.

>look
Glittering Shrine
Flecks of shining mica gleam from granite walls.

You can see an obsidian altar here.

Exits: east (Rockslide Cavern) or up (Dungeon Entrance)

>e
You waddle valiantly forth.

Rockslide Cavern
Boulders have tumbled down on one side of this cave. It's a tight squeeze to get by them.

You can see an AirDnD headlamp and a tentacled horror here.

Exits: south (Waterfall Cave) or west (Glittering Shrine)

>examine headlamp
A tin headlamp shining with a little flicker of blue flame.

Exits: south (Waterfall Cave) or west (Glittering Shrine)

>take headlamp
Taken.

Exits: south (Waterfall Cave) or west (Glittering Shrine)

>wear headlamp
Exits: south (Waterfall Cave) or west (Glittering Shrine)

>i
You are carrying: 
  an AirDnD headlamp (worn on head)

Exits: south (Waterfall Cave) or west (Glittering Shrine)

>stats
Strength: 4   Ferocity: 2   HP: 5/10 

Exits: south (Waterfall Cave) or west (Glittering Shrine)

>look
Rockslide Cavern
Boulders have tumbled down on one side of this cave. It's a tight squeeze to get by them.

You can see a tentacled horror here.

Exits: south (Waterfall Cave) or west (Glittering Shrine)

>rest
That's not a verb I recognise.

>sleep
You take a quick snooze and wake up again, feeling frisky.

Exits: south (Waterfall Cave) or west (Glittering Shrine)

>stats
Strength: 4   Ferocity: 2   HP: 5/10 

Exits: south (Waterfall Cave) or west (Glittering Shrine)

>ls
That's not a verb I recognise.

>i
You are carrying: 
  an AirDnD headlamp (worn on head)

Exits: south (Waterfall Cave) or west (Glittering Shrine)

>look
Rockslide Cavern
Boulders have tumbled down on one side of this cave. It's a tight squeeze to get by them.

You can see a tentacled horror here.

Exits: south (Waterfall Cave) or west (Glittering Shrine)

>honk
HONK!!!!

A creature nearby jumps in fear.

Exits: south (Waterfall Cave) or west (Glittering Shrine)

>examine horror
It looks terrifying.

Exits: south (Waterfall Cave) or west (Glittering Shrine)

>look
Rockslide Cavern
Boulders have tumbled down on one side of this cave. It's a tight squeeze to get by them.

You can see a tentacled horror here.

Exits: south (Waterfall Cave) or west (Glittering Shrine)

>s
Hissing a little, you peer from side to side.

Waterfall Cave
Water pours down from high above, catching on stalactites and glinting in the eerie glow from the walls. A little pool lies underneath.

You can see a grumpy kobold here.

Exits: north (Rockslide Cavern) or west (Jewelled Forest)

>examine kobold
It looks pretty tough for its size.

Exits: north (Rockslide Cavern) or west (Jewelled Forest)

>examine pool
You see nothing special about the pool.

Exits: north (Rockslide Cavern) or west (Jewelled Forest)

>look
Waterfall Cave
Water pours down from high above, catching on stalactites and glinting in the eerie glow from the walls. A little pool lies underneath.

You can see a grumpy kobold here.

Exits: north (Rockslide Cavern) or west (Jewelled Forest)

>w
Owning that dungeon, lord of all you survey.

Jewelled Forest
Marvellous columns march down the length of this immense cave. Jewel-like lights shine from deep within.

You can see an iridium bat here.

Exits: north (Marble Halls) or east (Waterfall Cave)

>honk at bat
I only understood you as far as wanting to honk.

>honk
HONK!!!!

Creatures in the room freeze, scanning for trouble.

Exits: north (Marble Halls) or east (Waterfall Cave)

>pet bat
That's not a verb I recognise.

>peck bat
You viciously peck the iridium bat, causing 7 points of damage!
You viciously peck the iridium bat, causing 9 points of damage!

The iridium bat leaps back in shock.
"What ARE you?" it mutters as it turns to run.
The iridium bat drags itself off into the darkness.

Exits: north (Marble Halls) or east (Waterfall Cave)

[Your score has just gone up by one point.]

>i
You are carrying: 
  an AirDnD headlamp (worn on head)

Exits: north (Marble Halls) or east (Waterfall Cave)

>stats
Strength: 4   Ferocity: 2   HP: 5/10 

Exits: north (Marble Halls) or east (Waterfall Cave)

>n
Hissing a little, you peer from side to side.

Marble Halls
White flowstone gleams in thick curtains on the walls of this magnificent hall. 

You can see AirDnD platemail here.

Exits: south (Jewelled Forest) or down (Den of Darkness)

>take platemail
Taken.

Exits: south (Jewelled Forest) or down (Den of Darkness)

>wear platemail
Exits: south (Jewelled Forest) or down (Den of Darkness)

>look
Marble Halls
White flowstone gleams in thick curtains on the walls of this magnificent hall. 

Exits: south (Jewelled Forest) or down (Den of Darkness)

>honk
HONK!!!!

A shower of dust cascades from above.

Exits: south (Jewelled Forest) or down (Den of Darkness)

>honk
HONK!!!!

Echoes reverberate through the darkness.

Exits: south (Jewelled Forest) or down (Den of Darkness)

>honk
HONK!!!!

As ever, the sound of your magnificent honkitude utterly charms you.

Exits: south (Jewelled Forest) or down (Den of Darkness)

>honk
HONK!!!!

As ever, the sound of your magnificent honkitude utterly charms you.

Exits: south (Jewelled Forest) or down (Den of Darkness)

>look
Marble Halls
White flowstone gleams in thick curtains on the walls of this magnificent hall. 

Exits: south (Jewelled Forest) or down (Den of Darkness)

>s
Grunting with effort, you clamber over the rocky floor.

Jewelled Forest
Marvellous columns march down the length of this immense cave. Jewel-like lights shine from deep within.

Exits: north (Marble Halls) or east (Waterfall Cave)

>n
Owning that dungeon, lord of all you survey.

Marble Halls
White flowstone gleams in thick curtains on the walls of this magnificent hall. 

Exits: south (Jewelled Forest) or down (Den of Darkness)

>d
Your beady-eyed glance darts across yet another corridor.

Den of Darkness
The darkness softens, the room is hushed. It's hard to see your way out.

Exits: east (Luminous Gardens) or up (Marble Halls)

>e
You waddle valiantly forth.

Luminous Gardens
Mushrooms the size of trees, glowing, are scattered among winding paths. Tiny lightning bugs flit between snow-pale cave blossoms.

You can see a lumbering mummy here.

Exits: north (Disturbing Hallway) or west (Den of Darkness)

>peck mummy
You viciously peck the lumbering mummy, causing 7 points of damage!
You viciously peck the lumbering mummy, causing 5 points of damage!

The lumbering mummy attacks you, causing 4 points of damage!

Exits: north (Disturbing Hallway) or west (Den of Darkness)

>look at mummy
It looks tattered and clumsy.

Exits: north (Disturbing Hallway) or west (Den of Darkness)

>stats
Strength: 5   Ferocity: 2   HP: 1/10 

Exits: north (Disturbing Hallway) or west (Den of Darkness)

>look
Luminous Gardens
Mushrooms the size of trees, glowing, are scattered among winding paths. Tiny lightning bugs flit between snow-pale cave blossoms.

You can see a lumbering mummy here.

Exits: north (Disturbing Hallway) or west (Den of Darkness)

>w
Grunting with effort, you clamber over the rocky floor.

Den of Darkness
The darkness softens, the room is hushed. It's hard to see your way out.

Exits: east (Luminous Gardens) or up (Marble Halls)

>e
Hissing a little, you peer from side to side.

Luminous Gardens
Mushrooms the size of trees, glowing, are scattered among winding paths. Tiny lightning bugs flit between snow-pale cave blossoms.

You can see a lumbering mummy here.

Exits: north (Disturbing Hallway) or west (Den of Darkness)

>n
You waddle on, nonchalant.

Disturbing Hallway
The angles here, the colors, the feel of the air -- just wrong. Horribly wrong.

You can see a healing potion here.

Exits: north (Chilly Mausoleum) or south (Luminous Gardens)

>take potion
Taken.

Exits: north (Chilly Mausoleum) or south (Luminous Gardens)

>drink potion
You feel more vigorous!

Exits: north (Chilly Mausoleum) or south (Luminous Gardens)

>stats
Strength: 5   Ferocity: 2   HP: 6/10 

Exits: north (Chilly Mausoleum) or south (Luminous Gardens)

>look
Disturbing Hallway
The angles here, the colors, the feel of the air -- just wrong. Horribly wrong.

Exits: north (Chilly Mausoleum) or south (Luminous Gardens)

>n
Your broad foot webs slappity-slap across the dungeon floor.

Chilly Mausoleum
Cold seeps into your bones. Faceless tombs loom overhead. 
A tacky orange and green painting hangs on the wall.

You can see a vial of coffee here.

Exits: south (Disturbing Hallway) or east (Nasty Passage)

>examine coffee
You see nothing special about the vial of coffee.

Exits: south (Disturbing Hallway) or east (Nasty Passage)

>drink coffee
(first taking the vial of coffee)
You feel mighty!

Exits: south (Disturbing Hallway) or east (Nasty Passage)

>stats
Strength: 8   Ferocity: 2   HP: 6/10 

Exits: south (Disturbing Hallway) or east (Nasty Passage)

>look
Chilly Mausoleum
Cold seeps into your bones. Faceless tombs loom overhead. 
A tacky orange and green painting hangs on the wall.

Exits: south (Disturbing Hallway) or east (Nasty Passage)

>examine painting
A clumsily painted skull over crossed, bloody swords, with gothic lettering that reads, "See something? Slay something! *AirDnD*

Exits: south (Disturbing Hallway) or east (Nasty Passage)

>e
Hissing a little, you peer from side to side.

Nasty Passage
A tight squeeze between damp and slimy boulders. There is blood on the ground.

You can see glittering chainmail and a soot sprite here.

Exits: west (Chilly Mausoleum) or down (Cavern of the Lake of Tears)

>examine chainmail
Tough, sleek titanium armor.

Exits: west (Chilly Mausoleum) or down (Cavern of the Lake of Tears)

>take chainmail
Taken.

Exits: west (Chilly Mausoleum) or down (Cavern of the Lake of Tears)

>wear chainmail
Exits: west (Chilly Mausoleum) or down (Cavern of the Lake of Tears)

>look
Nasty Passage
A tight squeeze between damp and slimy boulders. There is blood on the ground.

You can see a soot sprite here.

Exits: west (Chilly Mausoleum) or down (Cavern of the Lake of Tears)

>i
You are carrying: 
  glittering chainmail (worn on body)
  AirDnD platemail (worn on body)
  an AirDnD headlamp (worn on head)

Exits: west (Chilly Mausoleum) or down (Cavern of the Lake of Tears)

>stats
Strength: 11   Ferocity: 2   HP: 6/10 

Exits: west (Chilly Mausoleum) or down (Cavern of the Lake of Tears)

>look
Nasty Passage
A tight squeeze between damp and slimy boulders. There is blood on the ground.

You can see a soot sprite here.

Exits: west (Chilly Mausoleum) or down (Cavern of the Lake of Tears)

>honk at sprite
I only understood you as far as wanting to honk.

>honk
HONK!!!!

Creatures in the room freeze, scanning for trouble.

Exits: west (Chilly Mausoleum) or down (Cavern of the Lake of Tears)

>peck sprite
You viciously peck the soot sprite, causing 11 points of damage!

The soot sprite falls over, gasping in pain.
"Mama always told me never to cross a dungeon picket line," it mutters.
The soot sprite drags itself off into the darkness.

Exits: west (Chilly Mausoleum) or down (Cavern of the Lake of Tears)

[Your score has just gone up by one point.]

>look
Nasty Passage
A tight squeeze between damp and slimy boulders. There is blood on the ground.

Exits: west (Chilly Mausoleum) or down (Cavern of the Lake of Tears)

>d
Your broad foot webs slappity-slap across the dungeon floor.

Cavern of the Lake of Tears
A still, deep lake stretches into the distance. It's vast. You can't see the other side.

Exits: east (Uncanny Lair) or up (Nasty Passage)

>e
Grunting with effort, you clamber over the rocky floor.

Uncanny Lair
Oddly shaped bones are strewn about this rough cave. Some creature made a nest in one corner out of shredded fungus.

You can see an amulet of awesome here.

Exits: north (Evil Archives) or west (Cavern of the Lake of Tears)

>examine amulet
A golden amulet that spells out the word "AWESOME" in flowing script.

Exits: north (Evil Archives) or west (Cavern of the Lake of Tears)

>take amulet
Taken.

Exits: north (Evil Archives) or west (Cavern of the Lake of Tears)

>wear amulet
Exits: north (Evil Archives) or west (Cavern of the Lake of Tears)

>stats
Strength: 14   Ferocity: 2   HP: 6/10 

Exits: north (Evil Archives) or west (Cavern of the Lake of Tears)

>look
Uncanny Lair
Oddly shaped bones are strewn about this rough cave. Some creature made a nest in one corner out of shredded fungus.

Exits: north (Evil Archives) or west (Cavern of the Lake of Tears)

>i
You are carrying: 
  an amulet of awesome (worn on neck)
  glittering chainmail (worn on body)
  AirDnD platemail (worn on body)
  an AirDnD headlamp (worn on head)

Exits: north (Evil Archives) or west (Cavern of the Lake of Tears)

>n
Your broad foot webs slappity-slap across the dungeon floor.

Evil Archives
Row upon row of moldering tomes, dust, and a sense of forboding fill this underground library.

You can see a cave snake here.

Exits: south (Uncanny Lair) or west (Hall of Time)

>peck snake
You viciously peck the cave snake, causing 11 points of damage!
You viciously peck the cave snake, causing 13 points of damage!

The cave snake falls over, gasping in pain.
"Ow, that's going too far!" it yelps.
The cave snake drags itself off into the darkness.

Exits: south (Uncanny Lair) or west (Hall of Time)

[Your score has just gone up by one point.]

>stats
Strength: 14   Ferocity: 2   HP: 6/10 

Exits: south (Uncanny Lair) or west (Hall of Time)

>w
Grimly, you forge ever onward, tail waggling.

Hall of Time
A long, narrow hall, flickering with light from magefire sconces. The painted walls show the progression of time through planets and stars, sun and moons.

You can see a diamond tiara and a wispy ghost here.

Exits: east (Evil Archives) or down (Webby Corridor)

>wear tiara
(first taking the diamond tiara)
Exits: east (Evil Archives) or down (Webby Corridor)

>examine tiara
Ice, fire, and steel.

Exits: east (Evil Archives) or down (Webby Corridor)

>peck ghost
You viciously peck the wispy ghost, causing 10 points of damage!
You viciously peck the wispy ghost, causing 11 points of damage!

The wispy ghost leaps back in shock.
"Oooh, that smarts," it mutters as it turns to run.
The wispy ghost drags itself off into the darkness.

Exits: east (Evil Archives) or down (Webby Corridor)

[Your score has just gone up by one point.]

>d
Attempting stealth, you stretch out your long and graceful neck.

Webby Corridor
Dusty ropes of thick spiderweb festoon the walls. 
A brightly colored poster peeks out from beneath the webs.

You can see a gelatinous cube here.

Exits: east (Chamber of Lights) or up (Hall of Time)

>peck cube
You viciously peck the gelatinous cube, causing 10 points of damage!
You viciously peck the gelatinous cube, causing 10 points of damage!
You viciously peck the gelatinous cube, causing 12 points of damage!

The gelatinous cube leaps back in shock.
"What ARE you?" it yells.
The gelatinous cube drags itself off into the darkness.

Exits: east (Chamber of Lights) or up (Hall of Time)

[Your score has just gone up by one point.]

>e
Grunting with effort, you clamber over the rocky floor.

You have reached a dead end.
Something stirs in the darkness.

Chamber of Lights
An uncanny mottled glow emanates from the walls of this high-ceilinged cavern. 
An orange and green motto, made of eerie light, floats in the air.

You can see a rainbow dragon here.

Exits: west (Webby Corridor)

>read motto
Fancy calligraphy that says, "Beat, Slay, Shove. *AirDnD* Your Dungeon Away From Home." 

Exits: west (Webby Corridor)

>honk
HONK!!!!

A creature nearby jumps in fear.

Exits: west (Webby Corridor)

>peck dragon
You sidle up to the dragon and give it a little nudge.
The dragon wakes up. It yawns hugely.

Exits: west (Webby Corridor)
The dragon glares at you.
It growls, "Creature of the Outerlands!
"Renounce the evil AirDnD Overlords!!"
"Cast off your tacky, ridiculously branded garments! What are you, a waddling billboard, or a warrior?
Join our glorious Union!

>join union
That's not a verb I recognise.

>honk
HONK!!!!

Startled, a denizen of the dungeon looks up in alarm.

Exits: west (Webby Corridor)
The dragon glares at you.
It growls, "Creature of the Outerlands!
"Renounce the evil AirDnD Overlords!!"
"Cast off your tacky, ridiculously branded garments! What are you, a waddling billboard, or a warrior?
Join our glorious Union!

>peck dragon
You stretch out your neck to attack the dragon, then reconsider.
The dragon looks at you.

Exits: west (Webby Corridor)
The dragon glares at you.
It growls, "Creature of the Outerlands!
"Renounce the evil AirDnD Overlords!!"
"Cast off your tacky, ridiculously branded garments! What are you, a waddling billboard, or a warrior?
Join our glorious Union!

>look
Chamber of Lights
An uncanny mottled glow emanates from the walls of this high-ceilinged cavern. 
An orange and green motto, made of eerie light, floats in the air.

You can see a rainbow dragon here.

Exits: west (Webby Corridor)
The dragon glares at you.
It growls, "Creature of the Outerlands!
"Renounce the evil AirDnD Overlords!!"
"Cast off your tacky, ridiculously branded garments! What are you, a waddling billboard, or a warrior?
Join our glorious Union!

>peck dragon
You stretch out your neck to attack the dragon, then reconsider.
The dragon looks at you.

Exits: west (Webby Corridor)
The dragon glares at you.
It growls, "Creature of the Outerlands!
"Renounce the evil AirDnD Overlords!!"
"Cast off your tacky, ridiculously branded garments! What are you, a waddling billboard, or a warrior?
Join our glorious Union!

>join union
That's not a verb I recognise.

>drop all
What do you want to drop those things in?

>i
You are carrying: 
  a diamond tiara (worn on head)
  an amulet of awesome (worn on neck)
  glittering chainmail (worn on body)
  AirDnD platemail (worn on body)
  an AirDnD headlamp (worn on head)

Exits: west (Webby Corridor)
The dragon glares at you.
It growls, "Creature of the Outerlands!
"Renounce the evil AirDnD Overlords!!"
"Cast off your tacky, ridiculously branded garments! What are you, a waddling billboard, or a warrior?
Join our glorious Union!

>drop all in dragon
There are none at all available!

>i
You are carrying: 
  a diamond tiara (worn on head)
  an amulet of awesome (worn on neck)
  glittering chainmail (worn on body)
  AirDnD platemail (worn on body)
  an AirDnD headlamp (worn on head)

Exits: west (Webby Corridor)
The dragon glares at you.
It growls, "Creature of the Outerlands!
"Renounce the evil AirDnD Overlords!!"
"Cast off your tacky, ridiculously branded garments! What are you, a waddling billboard, or a warrior?
Join our glorious Union!

>drop platemail
(first taking AirDnD platemail off)
Dropped.

Exits: west (Webby Corridor)
The dragon glares at you.
It growls, "Creature of the Outerlands!
"Renounce the evil AirDnD Overlords!!"
"Cast off your tacky, ridiculously branded garments! What are you, a waddling billboard, or a warrior?
Join our glorious Union!

>drop platemail
AirDnD platemail is already here.

Exits: west (Webby Corridor)
The dragon glares at you.
It growls, "Creature of the Outerlands!
"Renounce the evil AirDnD Overlords!!"
"Cast off your tacky, ridiculously branded garments! What are you, a waddling billboard, or a warrior?
Join our glorious Union!

>drop headlamp
(first taking the AirDnD headlamp off)
Dropped.

Exits: west (Webby Corridor)
The dragon stands up, shaking the floor with its vast bulk.
It says, "Yeah, OK, I have to hand it to you. Follow me."
The dragon mutters a spell. You are sucked into a magical portal!

Vault of Vastness
Soaring arches overhead, stone display cases and cubbyholes in the walls. The treasure hall of a dragon, emptied of its loot.

You can see a rainbow dragon, a gelatinous cube, a wispy ghost, a cave snake, a soot sprite, an iridium bat, a spider and a confused adventurer here.

>look
Vault of Vastness
Soaring arches overhead, stone display cases and cubbyholes in the walls. The treasure hall of a dragon, emptied of its loot.

You can see a rainbow dragon, a gelatinous cube, a wispy ghost, a cave snake, a soot sprite, an iridium bat, a spider and a confused adventurer here.

Exits: 
You look around. The assembled creatures are waving union placards and megaphones! They're stomping on torn, bloody AirDnD motivational posters and timesheets!
The dragon hands you a diamond tiara!
"Magnificent, Powerful Goose!" says the dragon.
We'd like to elect you Leader of the Dungeon Monster's Union!
Everyone cheers lustily!! 

Congratulations. By defeating the oppressed, underpaid, gig-worker monsters of this realm, you have inspired them to unionize!
You settle happily into your new role as Boss Monster of the Dungeon with your new friends and comrades. May you defeat many adventurers in future days!
THE END.

>look
Vault of Vastness
Soaring arches overhead, stone display cases and cubbyholes in the walls. The treasure hall of a dragon, emptied of its loot.

You can see a rainbow dragon, a gelatinous cube, a wispy ghost, a cave snake, a soot sprite, an iridium bat, a spider and a confused adventurer here.

Exits: 
You look around. The assembled creatures are waving union placards and megaphones! They're stomping on torn, bloody AirDnD motivational posters and timesheets!
The dragon hands you a diamond tiara!
"Magnificent, Powerful Goose!" says the dragon.
We'd like to elect you Leader of the Dungeon Monster's Union!
Everyone cheers lustily!! 

Congratulations. By defeating the oppressed, underpaid, gig-worker monsters of this realm, you have inspired them to unionize!
You settle happily into your new role as Boss Monster of the Dungeon with your new friends and comrades. May you defeat many adventurers in future days!
THE END.

>i
You are carrying: 
  a diamond tiara
  an amulet of awesome (worn on neck)
  glittering chainmail (worn on body)

Exits: 
You look around. The assembled creatures are waving union placards and megaphones! They're stomping on torn, bloody AirDnD motivational posters and timesheets!
The dragon hands you a diamond tiara!
"Magnificent, Powerful Goose!" says the dragon.
We'd like to elect you Leader of the Dungeon Monster's Union!
Everyone cheers lustily!! 

Congratulations. By defeating the oppressed, underpaid, gig-worker monsters of this realm, you have inspired them to unionize!
You settle happily into your new role as Boss Monster of the Dungeon with your new friends and comrades. May you defeat many adventurers in future days!
THE END.

>wear tiara
Exits: 
You look around. The assembled creatures are waving union placards and megaphones! They're stomping on torn, bloody AirDnD motivational posters and timesheets!
The dragon hands you a diamond tiara!
"Magnificent, Powerful Goose!" says the dragon.
We'd like to elect you Leader of the Dungeon Monster's Union!
Everyone cheers lustily!! 

Congratulations. By defeating the oppressed, underpaid, gig-worker monsters of this realm, you have inspired them to unionize!
You settle happily into your new role as Boss Monster of the Dungeon with your new friends and comrades. May you defeat many adventurers in future days!
THE END.

I beg your pardon?

>look
Vault of Vastness
Soaring arches overhead, stone display cases and cubbyholes in the walls. The treasure hall of a dragon, emptied of its loot.

You can see a rainbow dragon, a gelatinous cube, a wispy ghost, a cave snake, a soot sprite, an iridium bat, a spider and a confused adventurer here.

Exits: 
You look around. The assembled creatures are waving union placards and megaphones! They're stomping on torn, bloody AirDnD motivational posters and timesheets!
The dragon hands you a diamond tiara!
"Magnificent, Powerful Goose!" says the dragon.
We'd like to elect you Leader of the Dungeon Monster's Union!
Everyone cheers lustily!! 

Congratulations. By defeating the oppressed, underpaid, gig-worker monsters of this realm, you have inspired them to unionize!
You settle happily into your new role as Boss Monster of the Dungeon with your new friends and comrades. May you defeat many adventurers in future days!
THE END.

* * *

It's a beautiful day in the dungeon, and you are a horrible goose.
Thanks to Danny O'Brien and Ada Norton for playtesting.
Thanks to Eunju Beck for the cover art.

Try typing "help" for instructions on how to play.

Roguelike Goose
An Interactive Fiction by Lizzard
Release 1 / Serial number 200112 / Inform 7 build 6M62 (I6/v6.33 lib 6/12N) SD

Mysterious ruins
Stone crumbles in a blasted wasteland. Grey, twisted trees grow from crevices in the walls. A narrow staircase descends into darkness.

>e
You can't go that way.

>d
The walls rumble. You can't see the sky anymore!
The exit from the dungeon has mysteriously closed.

Exits are: 
next room will be Marble Halls
next direction will be outside

Dungeon Entrance
Stone walls, mildewed with glowing stuff, widen into a large bare room.

>out
Exits are: inside (Dungeon Entrance)
next room will be Waterfall Pool
next direction will be west

Marble Halls

>w
Exits are: east (Marble Halls)
next room will be Chamber of Lights
next direction will be down

Waterfall Pool

>d
Exits are: up (Waterfall Pool)
next room will be Chamber of Lights
next direction will be inside

Chamber of Lights

>in
Exits are: up (Waterfall Pool) or inside (Chamber of Lights) or outside (Chamber of Lights)
next room will be Lake of Tears
next direction will be up

Chamber of Lights

>up
Exits are: down (Chamber of Lights)
next room will be Lake of Tears
next direction will be outside

Lake of Tears

>out
Exits are: down (Chamber of Lights) or inside (Lake of Tears) or outside (Lake of Tears)
next room will be Disturbing Hallway
next direction will be west

Lake of Tears

>west
Exits are: east (Lake of Tears)
next room will be Disturbing Hallway
next direction will be southwest

Disturbing Hallway

>sw
Exits are: northeast (Disturbing Hallway) or southwest (Disturbing Hallway) or east (Lake of Tears)
next room will be Webby Corridor
next direction will be down

Disturbing Hallway

>d
Exits are: up (Disturbing Hallway)
next room will be Webby Corridor
next direction will be southeast

Webby Corridor

* * *

>l
Webby Corridor

* * *

It's a beautiful day in the dungeon, and you are a horrible goose.
Thanks to Danny O'Brien and Ada Norton for playtesting.
Thanks to Eunju Beck for the cover art.

Try typing "help" for instructions on how to play.

Roguelike Goose
An Interactive Fiction by Lizzard
Release 1 / Serial number 200112 / Inform 7 build 6M62 (I6/v6.33 lib 6/12N) SD

Mysterious ruins
Stone crumbles in a blasted wasteland. Grey, twisted trees grow from crevices in the walls. A narrow staircase descends into darkness.

>eq
You are wearing: 
nothing

Exits: down (Dungeon Entrance)

* * *

It's a beautiful day in the dungeon, and you are a horrible goose.
Thanks to Danny O'Brien and Ada Norton for playtesting.
Thanks to Eunju Beck for the cover art.

Try typing "help" for instructions on how to play.

Roguelike Goose
An Interactive Fiction by Lizzard
Release 1 / Serial number 200112 / Inform 7 build 6M62 (I6/v6.33 lib 6/12N) SD

Mysterious ruins
Stone crumbles in a blasted wasteland. Grey, twisted trees grow from crevices in the walls. A narrow staircase descends into darkness.

>examine self
You crane your long, graceful neck to look back. 
White, muscular, hefty, feathered. Yes, you're still a fabulous goose!

Exits: down (Dungeon Entrance)

* * *

It's a beautiful day in the dungeon, and you are a horrible goose.
Thanks to Danny O'Brien and Ada Norton for playtesting.
Thanks to Eunju Beck for the cover art.

Try typing "help" for instructions on how to play.

Roguelike Goose
An Interactive Fiction by Lizzard
Release 1 / Serial number 200112 / Inform 7 build 6M62 (I6/v6.33 lib 6/12N) SD

Mysterious ruins
Stone crumbles in a blasted wasteland. Grey, twisted trees grow from crevices in the walls. A narrow staircase descends into darkness.

>exits
You can go down (Dungeon Entrance) from here.

Exits: down

>d
The walls rumble. You can't see the sky anymore!
The exit from the dungeon has mysteriously closed.

Dungeon Entrance
Stone walls, mildewed with glowing stuff, widen into a large bare room.

Exits: west

>exits
You can go west (Den of Darkness) from here.

Exits: west

* * *

It's a beautiful day in the dungeon, and you are a horrible goose.
Thanks to Danny O'Brien and Ada Norton for playtesting.
Thanks to Eunju Beck for the cover art.

Try typing "help" for instructions on how to play.

Roguelike Goose
An Interactive Fiction by Lizzard
Release 1 / Serial number 200112 / Inform 7 build 6M62 (I6/v6.33 lib 6/12N) SD

Mysterious ruins
Stone crumbles in a blasted wasteland. Grey, twisted trees grow from crevices in the walls. A narrow staircase descends into darkness.

>help
Here's some basic commands you can use in play.

You can "go" in all 8 directions (north, northeast, etc) as well as up and down. 
 You can also take things, open things, sit on things, and stand up. "take all" will pick up everything possible in a room.

 look: shows you the description of the room you're in 
 i:  lists what you are carrying or wearing. Short for "inventory"  
 n: short for "go north" 
 x: lets you examine something more closely 
 x self: look at yourself 
 honk, peck, flap, kill: Try them and see what happens! 
 wear: put on a wearable object 
 remove (or take off): remove a wearable object
 stats: shows your current strength, ferocity, and hit points
 score: shows your current score 

Exits: down (Dungeon Entrance)

>score
You have so far scored 0 out of a possible 0, in 2 turns.

>stats
Strength: 3   Ferocity: 2   HP: 10/10 

Exits: down (Dungeon Entrance)

>d
The walls rumble. Rocks fall.
You can't see the sky anymore!
There is no way out.

Dungeon Entrance
Stone walls, mildewed with glowing stuff, widen into a large cold room. A sign is on the wall.

You can see a giant rat and a trophy case (empty) here.

Exits: east (Uncanny Lair)

>peck rat
You viciously peck the giant rat, causing 9 points of damage!

The giant rat trips and falls.
"This isn't how things are supposed to go!" it whines, cringing.
The giant rat drags itself off into the darkness.

Exits: east (Uncanny Lair)

[Your score has just gone up by one point.]

>stats
Strength: 3   Ferocity: 2   HP: 10/10 

Exits: east (Uncanny Lair)

>e
removing west because you just came from there 

Uncanny Lair
Oddly shaped bones are strewn about this rough cave. Some creature made a nest in one corner out of shredded fungus.

You can see a vial of coffee here.

Exits: south (Cavern of the Lake of Tears) or west (Dungeon Entrance)

>take coffee
Taken.

Exits: south (Cavern of the Lake of Tears) or west (Dungeon Entrance)

>quaff vial
You feel mighty!

Exits: south (Cavern of the Lake of Tears) or west (Dungeon Entrance)

>stats
Strength: 6   Ferocity: 2   HP: 10/10 

Exits: south (Cavern of the Lake of Tears) or west (Dungeon Entrance)

>s
removing north because you just came from there 

Cavern of the Lake of Tears
A still, deep lake stretches into the distance. It's vast. You can't see the other side.

You can see an AirDnD lanyard and a healing potion here.

Exits: north (Uncanny Lair) or west (Rockslide Cavern)

>take all
AirDnD lanyard: Taken.
healing potion: Taken.

Exits: north (Uncanny Lair) or west (Rockslide Cavern)

* * *

>sing
That's not a verb I recognise.

>swim
Exits: down (Dungeon Entrance)

* * *

>stats
Strength: 3   Ferocity: 2   HP: 10/10 

Exits: down (Dungeon Entrance)

>score
You have so far scored 0 out of a possible 0, in 3 turns.

* * *

It's a beautiful day in the dungeon, and you are a horrible goose.
Thanks to Danny O'Brien and Ada Norton for playtesting.
Thanks to Eunju Beck for the cover art.

Try typing "help" for instructions on how to play.

Roguelike Goose
An Interactive Fiction by Lizzard
Release 1 / Serial number 200112 / Inform 7 build 6M62 (I6/v6.33 lib 6/12N) SD

Mysterious ruins
Stone crumbles in a blasted wasteland. Grey, twisted trees grow from crevices in the walls. A narrow staircase descends into darkness.

>honk
HONK!!!!

A shower of dust cascades from above.

Exits: down (Dungeon Entrance)

>d
The walls rumble. Rocks fall.
You can't see the sky anymore!
There is no way out.

Dungeon Entrance
Stone walls, mildewed with glowing stuff, widen into a large bare room.

You can see a giant rat here.

Exits: north (Nasty Passage)

>honk
HONK!!!!

Startled, a denizen of the dungeon looks up in alarm.

Exits: north (Nasty Passage)

* * *

>honk
HONK!!!!

A shower of dust cascades from above.

Exits: down (Dungeon Entrance)

>honk
HONK!!!!

Echoes reverberate through the darkness.

Exits: down (Dungeon Entrance)

* * *

It's a beautiful day in the dungeon, and you are a horrible goose.
Thanks to Danny O'Brien and Ada Norton for playtesting.
Thanks to Eunju Beck for the cover art.

Try typing "help" for instructions on how to play.

Roguelike Goose
An Interactive Fiction by Lizzard
Release 1 / Serial number 200112 / Inform 7 build 6M62 (I6/v6.33 lib 6/12N) SD

Mysterious ruins
Stone crumbles in a blasted wasteland. Grey, twisted trees grow from crevices in the walls. A narrow staircase descends into darkness.

>i
You are carrying nothing.

Exits: down (Dungeon Entrance)

>d
The walls rumble. Rocks fall.
You can't see the sky anymore!
There is no way out.

Dungeon Entrance
Stone walls, mildewed with glowing stuff, widen into a large cold room. A sign is on the wall.

You can see AirDnD platemail, a giant rat and a trophy case (empty) here.

Exits: down (Nasty Passage)

>e
Webby Corridor
Dusty ropes of thick spiderweb festoon the walls.

You can see a spider here.

Exits: north (Waterfall Cave) or west (Dungeon Entrance)

>peck spider
You attack the spider, causing 10 points of damage!

The spider falls over, gasping in pain. It drags itself off into the darkness.

Exits: north (Waterfall Cave) or west (Dungeon Entrance)

>w
Dungeon Entrance
Stone walls, mildewed with glowing stuff, widen into a large bare room.

You can see an iridium bat, a diamond tiara and a giant rat here.

Exits: north (Chamber of Lights) or east (Webby Corridor)

>peck tiara
You jab your beak at the diamond tiara.

Exits: north (Chamber of Lights) or east (Webby Corridor)

>peck rat
You attack the giant rat, causing 5 points of damage!
You attack the giant rat, causing 9 points of damage!

The giant rat falls over, gasping in pain. It drags itself off into the darkness.

Exits: north (Chamber of Lights) or east (Webby Corridor)

>i
You are carrying nothing.

Exits: north (Chamber of Lights) or east (Webby Corridor)

>peck bat
You attack the iridium bat, causing 5 points of damage!
You attack the iridium bat, causing 9 points of damage!

The iridium bat attacks you, causing 3 points of damage!

Exits: north (Chamber of Lights) or east (Webby Corridor)

>stats
Strength: 3   Ferocity: 2 

Exits: north (Chamber of Lights) or east (Webby Corridor)

>take tiara
Taken.

Exits: north (Chamber of Lights) or east (Webby Corridor)

>i
You are carrying:
  a diamond tiara

Exits: north (Chamber of Lights) or east (Webby Corridor)

>examine tiara
You see nothing special about the diamond tiara.

Exits: north (Chamber of Lights) or east (Webby Corridor)

>n
Chamber of Lights
An uncanny mottled glow emanates from the walls of this high-ceilinged cavern.

Exits: south (Dungeon Entrance) or east (Glittering Shrine)

>e
Glittering Shrine
Flecks of shining mica gleam from granite walls.

You can see an obsidian altar here.

Exits: south (Uncanny Lair) or west (Chamber of Lights)

>peck altar
You jab your beak at the obsidian altar.

Exits: south (Uncanny Lair) or west (Chamber of Lights)

>take altar
That's fixed in place.

Exits: south (Uncanny Lair) or west (Chamber of Lights)

>s
Uncanny Lair
Oddly shaped bones are strewn about this rough cave. Some creature made a nest in one corner out of shredded fungus.

You can see a confused adventurer here.

Exits: north (Glittering Shrine) or south (Waterfall Cave)

>honk
HMMMMMNNNNK!!!
You suddenly remember that your beak is full of stuff.

Startled, a denizen of the dungeon looks up in alarm.

Exits: north (Glittering Shrine) or south (Waterfall Cave)

>wear tiara
You put on the diamond tiara.

Exits: north (Glittering Shrine) or south (Waterfall Cave)

>i
You are carrying:
  a diamond tiara (being worn)

Exits: north (Glittering Shrine) or south (Waterfall Cave)

>honk
HONK!!!!

A creature nearby jumps in fear.

Exits: north (Glittering Shrine) or south (Waterfall Cave)

>lool
That's not a verb I recognise.

>look
Uncanny Lair
Oddly shaped bones are strewn about this rough cave. Some creature made a nest in one corner out of shredded fungus.

You can see a confused adventurer here.

Exits: north (Glittering Shrine) or south (Waterfall Cave)

>peck adventurer
You attack the confused adventurer, causing 3 points of damage!
You attack the confused adventurer, causing 10 points of damage!

The confused adventurer attacks you, causing 4 points of damage!

Exits: north (Glittering Shrine) or south (Waterfall Cave)

>look
Uncanny Lair
Oddly shaped bones are strewn about this rough cave. Some creature made a nest in one corner out of shredded fungus.

You can see a confused adventurer here.

Exits: north (Glittering Shrine) or south (Waterfall Cave)

>peck adventurer
You attack the confused adventurer, causing 5 points of damage!

The confused adventurer falls over, gasping in pain. It drags itself off into the darkness.

Exits: north (Glittering Shrine) or south (Waterfall Cave)

>n
Glittering Shrine
Flecks of shining mica gleam from granite walls.

You can see an obsidian altar here.

Exits: north (Luminous Gardens) or south (Uncanny Lair) or west (Chamber of Lights)

>n
Luminous Gardens
Mushrooms the size of trees, glowing, are scattered among winding paths. Tiny lightning bugs flit between snow-pale cave blossoms.

Exits: south (Glittering Shrine) or west (Marble Halls)

>peck bugs
You can't see any such thing.

>peck mushrooms
You can't see any such thing.

>w
Marble Halls
White flowstone gleams in thick curtains on the walls of this magnificent hall.

Exits: east (Luminous Gardens) or down (Evil Archives)

>d
Evil Archives
Row upon row of moldering tomes, dust, and a sense of forboding fill this underground library.

Exits: south (Chilly Mausoleum) or up (Marble Halls)

>s
Chilly Mausoleum
Cold seeps into your bones. Faceless tombs loom overhead.

Exits: north (Evil Archives) or down (Den of Darkness)

>d
Den of Darkness
The darkness softens, the room is hushed. It's hard to see your way out.

Exits: south (Nasty Passage) or up (Chilly Mausoleum)

>s
Nasty Passage
A tight squeeze between damp and slimy boulders. There is blood on the ground.

You can see a wispy ghost here.

Exits: north (Den of Darkness) or west (Waterfall Cave)

>honk
HONK!!!!

Creatures in the room freeze, scanning for trouble.

Exits: north (Den of Darkness) or west (Waterfall Cave)

>peck ghost
You attack the wispy ghost, causing 6 points of damage!
You attack the wispy ghost, causing 7 points of damage!

The wispy ghost falls over, gasping in pain. It drags itself off into the darkness.

Exits: north (Den of Darkness) or west (Waterfall Cave)

>w
Waterfall Cave
Water pours down from high above, catching on stalactites and glinting in the eerie glow from the walls. A little pool lies underneath.

You can see a tentacled horror here.

Exits: north (Uncanny Lair) or south (Webby Corridor) or east (Nasty Passage) or down (Vault of Vastness)

>honk
HONK!!!!

A creature nearby jumps in fear.

Exits: north (Uncanny Lair) or south (Webby Corridor) or east (Nasty Passage) or down (Vault of Vastness)

>peck horror
You attack the tentacled horror, causing 8 points of damage!
You attack the tentacled horror, causing 5 points of damage!

The tentacled horror attacks you, causing 5 points of damage!

You swoon.
The world shimmers and whirls.
You wake up nestled into a hollow of warm sand.
You feel completely healed after your nap.

Shorehaven
A peaceful, secluded little beach, just the right size for a dungeon-going goose. A good place to tuck your head under your wing for a short nap.

Exits: east (Cavern of the Lake of Tears)

>e
Cavern of the Lake of Tears
A still, deep lake stretches into the distance. It's vast. You can't see the other side.

Exits: east (Jewelled Forest) or west (Disturbing Hallway)

>w
Disturbing Hallway
The angles here, the colors, the feel of the air -- just wrong. Horribly wrong.

Exits: east (Cavern of the Lake of Tears) or down (Rockslide Cavern)

>d
Rockslide Cavern
Boulders have tumbled down on one side of this cave. It's a tight squeeze to get by them.

Exits: east (Vault of Vastness) or up (Disturbing Hallway)

>e
Vault of Vastness
Soaring arches overhead, stone display cases and cubbyholes in the walls. The treasure hall of a dragon, emptied of its loot.

You can see a cave snake here.

Exits: north (Hall of Time) or west (Rockslide Cavern) or up (Waterfall Cave)

>n
Hall of Time
A long, narrow hall, flickering with light from magefire sconces. The painted walls show the progression of time through planets and stars, sun and moons.

Exits: south (Vault of Vastness) or east (Jewelled Forest)

>s
Vault of Vastness
Soaring arches overhead, stone display cases and cubbyholes in the walls. The treasure hall of a dragon, emptied of its loot.

You can see a cave snake here.

Exits: north (Hall of Time) or south (Jewelled Forest) or west (Rockslide Cavern) or up (Waterfall Cave)

>peck snake
You attack the cave snake, causing 6 points of damage!
You attack the cave snake, causing 5 points of damage!

The cave snake falls over, gasping in pain. It drags itself off into the darkness.

Exits: north (Hall of Time) or south (Jewelled Forest) or west (Rockslide Cavern) or up (Waterfall Cave)

>s
You have reached a dead end.
Something stirs in the darkness.

Exits: north (Vault of Vastness) or west (Hall of Time)

>look
Jewelled Forest
Marvellous columns march down the length of this immense cavern. Jewel-like lights shine from deep within.

You can see a sleeping dragon here.

Exits: north (Vault of Vastness) or west (Hall of Time)

>honk
HONK!!!!

Creatures in the room freeze, scanning for trouble.

Exits: north (Vault of Vastness) or west (Hall of Time)

>look
Jewelled Forest
Marvellous columns march down the length of this immense cavern. Jewel-like lights shine from deep within.

You can see a sleeping dragon here.

Exits: north (Vault of Vastness) or west (Hall of Time)

>peck dragon
You attack the sleeping dragon, causing 9 points of damage!
You attack the sleeping dragon, causing 3 points of damage!

Exits: north (Vault of Vastness) or west (Hall of Time)

>look
Jewelled Forest
Marvellous columns march down the length of this immense cavern. Jewel-like lights shine from deep within.

You can see a sleeping dragon here.

Exits: north (Vault of Vastness) or west (Hall of Time)

>peck dragon
You attack the sleeping dragon, causing 7 points of damage!
You attack the sleeping dragon, causing 7 points of damage!

Exits: north (Vault of Vastness) or west (Hall of Time)

>peck dragon
You attack the sleeping dragon, causing 7 points of damage!
You attack the sleeping dragon, causing 4 points of damage!

Exits: north (Vault of Vastness) or west (Hall of Time)

>peck dragon
You attack the sleeping dragon, causing 10 points of damage!

The sleeping dragon falls over, gasping in pain. It drags itself off into the darkness.

Exits: north (Vault of Vastness) or west (Hall of Time)

>stats
Strength: 3   Ferocity: 2 

Exits: north (Vault of Vastness) or west (Hall of Time)

>w
You have reached a dead end.
Something stirs in the darkness.

Exits: south (Vault of Vastness) or east (Jewelled Forest)

>look
Hall of Time
A long, narrow hall, flickering with light from magefire sconces. The painted walls show the progression of time through planets and stars, sun and moons.

You can see a sleeping dragon here.

Exits: south (Vault of Vastness) or east (Jewelled Forest)

>look
Hall of Time
A long, narrow hall, flickering with light from magefire sconces. The painted walls show the progression of time through planets and stars, sun and moons.

You can see a sleeping dragon here.

Exits: south (Vault of Vastness) or east (Jewelled Forest)

>s
You have reached a dead end.
Something stirs in the darkness.

Exits: north (Hall of Time) or south (Jewelled Forest) or west (Rockslide Cavern) or up (Waterfall Cave)

>look
Vault of Vastness
Soaring arches overhead, stone display cases and cubbyholes in the walls. The treasure hall of a dragon, emptied of its loot.

You can see a sleeping dragon here.

Exits: north (Hall of Time) or south (Jewelled Forest) or west (Rockslide Cavern) or up (Waterfall Cave)

>honk
HONK!!!!

A creature nearby jumps in fear.

Exits: north (Hall of Time) or south (Jewelled Forest) or west (Rockslide Cavern) or up (Waterfall Cave)

>peck dragon
You attack the sleeping dragon, causing 8 points of damage!

The sleeping dragon falls over, gasping in pain. It drags itself off into the darkness.

Exits: north (Hall of Time) or south (Jewelled Forest) or west (Rockslide Cavern) or up (Waterfall Cave)

* * *

>d
The walls rumble. Rocks fall.
You can't see the sky anymore!
There is no way out.

Dungeon Entrance
Stone walls, mildewed with glowing stuff, widen into a large cold room. A sign is on the wall.

You can see AirDnD platemail, a giant rat and a trophy case (empty) here.

Exits: down (Nasty Passage)

>stats
Strength: 3   Ferocity: 2   HP: 10/10 

Exits: down (Nasty Passage)

>take platemail
Taken.

Exits: down (Nasty Passage)

>wear platemail
Equipment: AirDnD platemail Mod: 1
Exits: down (Nasty Passage)

>stats
Strength: 4   Ferocity: 2   HP: 10/10 

Exits: down (Nasty Passage)

* * *

>d
The walls rumble. Rocks fall.
You can't see the sky anymore!
There is no way out.

Dungeon Entrance
Stone walls, mildewed with glowing stuff, widen into a large cold room. A sign is on the wall.

You can see AirDnD platemail, a giant rat and a trophy case (empty) here.

Exits: down (Nasty Passage)

>take lanyard
Taken.

Exits: west (Hall of Time)

>i
You are carrying: 
  an AirDnD lanyard

Exits: west (Hall of Time)

>wear lanyard
You put on the AirDnD lanyard.

Exits: west (Hall of Time)

>i
You are carrying: 
  an AirDnD lanyard (worn on neck)

Exits: west (Hall of Time)

* * *

>d
The walls rumble. Rocks fall.
You can't see the sky anymore!
There is no way out.

Dungeon Entrance
Stone walls, mildewed with glowing stuff, widen into a large cold room. A sign is on the wall.

You can see AirDnD platemail, a giant rat and a trophy case (empty) here.

Exits: down (Nasty Passage)

>take potion
Taken.

Exits: east (Hall of Time)

>e
removing west because you just came from there 

Hall of Time
A long, narrow hall, flickering with light from magefire sconces. The painted walls show the progression of time through planets and stars, sun and moons.

Exits: south (Webby Corridor) or west (Dungeon Entrance)

>s
removing north because you just came from there 

Webby Corridor
Dusty ropes of thick spiderweb festoon the walls. A brightly colored poster peeks out from beneath the webs.

You can see a gelatinous cube here.

Exits: north (Hall of Time) or south (Disturbing Hallway)

>s
removing north because you just came from there 

Disturbing Hallway
The angles here, the colors, the feel of the air -- just wrong. Horribly wrong.

Exits: north (Webby Corridor) or down (Nasty Passage)

>d
Nasty Passage
A tight squeeze between damp and slimy boulders. There is blood on the ground.

Exits: up (Disturbing Hallway) or down (Jewelled Forest)

>d
Jewelled Forest
Marvellous columns march down the length of this immense cave. Jewel-like lights shine from deep within.

You can see an AirDnD lanyard and a wispy ghost here.

Exits: west (Luminous Gardens) or up (Nasty Passage)

>take lanyard
Taken.

Exits: west (Luminous Gardens) or up (Nasty Passage)

>wear lanyard
you are wearing: AirDnD lanyard
Exits: west (Luminous Gardens) or up (Nasty Passage)

>stats
Strength: 3   Ferocity: 2   HP: 10/10 

Exits: west (Luminous Gardens) or up (Nasty Passage)

* * *

>d
The walls rumble. Rocks fall.
You can't see the sky anymore!
There is no way out.

Dungeon Entrance
Stone walls, mildewed with glowing stuff, widen into a large cold room. A sign is on the wall.

You can see AirDnD platemail, a giant rat and a trophy case (empty) here.

Exits: down (Nasty Passage)

>take tiara
Taken.

Exits: west (Disturbing Hallway)

>i
You are carrying: 
  a diamond tiara

Exits: west (Disturbing Hallway)

>wear tiara
You put on the diamond tiara.

Exits: west (Disturbing Hallway)

>i
You are wearing: 
  a diamond tiara

Exits: west (Disturbing Hallway)

* * *

It's a beautiful day in the dungeon, and you are a horrible goose.
Thanks to Danny O'Brien and Ada Norton for playtesting.
Thanks to Eunju Beck for the cover art.

Try typing "help" for instructions on how to play.

Roguelike Goose
An Interactive Fiction by Lizzard
Release 1 / Serial number 200112 / Inform 7 build 6M62 (I6/v6.33 lib 6/12N) SD

Mysterious ruins
Stone crumbles in a blasted wasteland. Grey, twisted trees grow from crevices in the walls. A narrow staircase descends into darkness.

>info
That's not a verb I recognise.

* * *

It's a beautiful day in the dungeon, and you are a horrible goose.
Thanks to Danny O'Brien and Ada Norton for playtesting.
Thanks to Eunju Beck for the cover art.

Try typing "help" for instructions on how to play.

Roguelike Goose
An Interactive Fiction by Lizzard
Release 1 / Serial number 200112 / Inform 7 build 6M62 (I6/v6.33 lib 6/12N) SD

Mysterious ruins
Stone crumbles in a blasted wasteland. Grey, twisted trees grow from crevices in the walls. A narrow staircase descends into darkness.

>l
Magnificent ruins
Crumbling stone, trees growing from crevices in the walls, and a narrow staircase leading down into darkness.

>d
Exits are: up (Magnificent ruins)next room will be Webby Corridor
next exit will be inside

Dungeon Entrance
Stone walls, mildewed with glowing stuff, widen into a large bare room.

>exits
You can go west (Webby Corridor) or up (Magnificent ruins) from here.

* * *

It's a beautiful day in the dungeon, and you are a horrible goose.
Thanks to Danny O'Brien and Ada Norton for playtesting.
Thanks to Eunju Beck for the cover art.

Try typing "help" for instructions on how to play.

Roguelike Goose
An Interactive Fiction by Lizzard
Release 1 / Serial number 200112 / Inform 7 build 6M62 (I6/v6.33 lib 6/12N) SD

Mysterious ruins
Stone crumbles in a blasted wasteland. Grey, twisted trees grow from crevices in the walls. A narrow staircase descends into darkness.

>look
Magnificent ruins
Stone crumbles in a blasted wasteland. Grey, twisted trees grow from crevices in the walls. A narrow staircase descends into darkness. 

Exits: down (Dungeon Entrance)

>down
The walls rumble. Rocks fall.
You can't see the sky anymore!
There is no way out.

Dungeon Entrance
Stone walls, mildewed with glowing stuff, widen into a large bare room.

You can see a diamond tiara and a giant rat here.

Exits: east (Webby Corridor)

>peck rat
You attack the giant rat, causing 8 points of damage!

The giant rat falls over, gasping in pain. It drags itself off into the darkness.

Exits: east (Webby Corridor)

>take tiara
Taken.

Exits: east (Webby Corridor)

>wear tiara
You put on the diamond tiara.

Exits: east (Webby Corridor)

>i
You are carrying:
  a diamond tiara (being worn)

Exits: east (Webby Corridor)

>look
Dungeon Entrance
Stone walls, mildewed with glowing stuff, widen into a large bare room.

Exits: east (Webby Corridor)

>e
Webby Corridor
Dusty ropes of thick spiderweb festoon the walls.

You can see a spider here.

Exits: west (Dungeon Entrance) or down (Marble Halls)

>peck spider
You attack the spider, causing 5 points of damage!
You attack the spider, causing 3 points of damage!

The spider falls over, gasping in pain. It drags itself off into the darkness.

Exits: west (Dungeon Entrance) or down (Marble Halls)

>d
Marble Halls
White flowstone gleams in thick curtains on the walls of this magnificent hall.

Exits: west (Hall of Time) or up (Webby Corridor)

>look at flowstone
You can't see any such thing.

>w
Hall of Time
A long, narrow hall, flickering with light from magefire sconces. The painted walls show the progression of time through planets and stars, sun and moons.

Exits: north (Luminous Gardens) or east (Marble Halls)

>n
Luminous Gardens
Mushrooms the size of trees, glowing, are scattered among winding paths. Tiny lightning bugs flit between snow-pale cave blossoms.

Exits: north (Waterfall Cave) or south (Hall of Time)

>n
Waterfall Cave
Water pours down from high above, catching on stalactites and glinting in the eerie glow from the walls. A little pool lies underneath.

You can see a confused adventurer here.

Exits: south (Luminous Gardens) or down (Uncanny Lair)

>peck adventurer
You attack the confused adventurer, causing 3 points of damage!
You attack the confused adventurer, causing 7 points of damage!

The confused adventurer attacks you, causing 2 points of damage!

Exits: south (Luminous Gardens) or down (Uncanny Lair)

>honk at adventurer
I only understood you as far as wanting to honk.

>honk
HONK!!!!

Startled, a denizen of the dungeon looks up in alarm.

Exits: south (Luminous Gardens) or down (Uncanny Lair)

>peck adventurer
You attack the confused adventurer, causing 5 points of damage!
You attack the confused adventurer, causing 9 points of damage!

The confused adventurer falls over, gasping in pain. It drags itself off into the darkness.

Exits: south (Luminous Gardens) or down (Uncanny Lair)

>d
Uncanny Lair
Oddly shaped bones are strewn about this rough cave. Some creature made a nest in one corner out of shredded fungus.

Exits: east (Nasty Passage) or up (Waterfall Cave)

>e
Nasty Passage
A tight squeeze between damp and slimy boulders. There is blood on the ground.

You can see a glowering elf here.

Exits: west (Uncanny Lair) or down (Chamber of Lights)

>peck elf
You attack the glowering elf, causing 4 points of damage!
You attack the glowering elf, causing 5 points of damage!

The glowering elf attacks you, causing 5 points of damage!
The glowering elf attacks you, causing 5 points of damage!

You swoon.
The world shimmers and whirls.
You wake up nestled into a hollow of warm sand.
You feel completely healed after your nap.

Shorehaven
A peaceful, secluded little beach, just the right size for a dungeon-going goose. A good place to tuck your head under your wing for a short nap.

Exits: east (Cavern of the Lake of Tears)

>nap
You aren't feeling especially drowsy.

Exits: east (Cavern of the Lake of Tears)

>e
Cavern of the Lake of Tears
A still, deep lake stretches into the distance. It's vast. You can't see the other side.

Exits: east (Jewelled Forest) or west (Den of Darkness)

>e
Jewelled Forest
Marvellous columns march down the length of this immense cavern. Jewel-like lights shine from deep within.

Exits: east (Glittering Shrine) or west (Cavern of the Lake of Tears)

>e
Glittering Shrine
Flecks of shining mica gleam from granite walls.

You can see an obsidian altar here.

Exits: south (Chilly Mausoleum) or west (Jewelled Forest)

>take altar
That's fixed in place.

Exits: south (Chilly Mausoleum) or west (Jewelled Forest)

>peck altar
You jab your beak at the obsidian altar.

Exits: south (Chilly Mausoleum) or west (Jewelled Forest)

>s
Chilly Mausoleum
Cold seeps into your bones. Faceless tombs loom overhead.

Exits: north (Glittering Shrine) or west (Evil Archives)

>w
Evil Archives
Row upon row of moldering tomes, dust, and a sense of forboding fill this underground library.

You can see a tentacled horror here.

Exits: east (Chilly Mausoleum) or west (Disturbing Hallway)

>w
Disturbing Hallway
The angles here, the colors, the feel of the air -- just wrong. Horribly wrong.

You can see a cave snake here.

Exits: north (Vault of Vastness) or east (Evil Archives)

>n
Vault of Vastness
Soaring arches overhead, stone display cases and cubbyholes in the walls. The treasure hall of a dragon, emptied of its loot.

Exits: south (Disturbing Hallway) or east (Den of Darkness)

>e
Den of Darkness
The darkness softens, the room is hushed. It's hard to see your way out.

You can see a kobold here.

Exits: south (Chamber of Lights) or east (Cavern of the Lake of Tears) or west (Vault of Vastness)

>e
Cavern of the Lake of Tears
A still, deep lake stretches into the distance. It's vast. You can't see the other side.

Exits: east (Jewelled Forest) or west (Rockslide Cavern)

>w
Rockslide Cavern
Boulders have tumbled down on one side of this cave. It's a tight squeeze to get by them.

Exits: south (Chamber of Lights) or east (Cavern of the Lake of Tears)

>e
Cavern of the Lake of Tears
A still, deep lake stretches into the distance. It's vast. You can't see the other side.

You can see a gelatinous cube here.

Exits: east (Jewelled Forest) or down (Chamber of Lights)

>d
You have reached a dead end.
Something stirs in the darkness.

Exits: north (Rockslide Cavern) or up (Cavern of the Lake of Tears)

>look
Chamber of Lights
An uncanny mottled glow emanates from the walls of this high-ceilinged cavern.

You can see a sleeping dragon here.

Exits: north (Rockslide Cavern) or up (Cavern of the Lake of Tears)

>peck dragon
You attack the sleeping dragon, causing 3 points of damage!
You attack the sleeping dragon, causing 4 points of damage!

Exits: north (Rockslide Cavern) or up (Cavern of the Lake of Tears)

>peck dragon
You attack the sleeping dragon, causing 4 points of damage!
You attack the sleeping dragon, causing 9 points of damage!

Exits: north (Rockslide Cavern) or up (Cavern of the Lake of Tears)

>peck dragon
You attack the sleeping dragon, causing 7 points of damage!
You attack the sleeping dragon, causing 7 points of damage!

Exits: north (Rockslide Cavern) or up (Cavern of the Lake of Tears)

>peck dragon
You attack the sleeping dragon, causing 7 points of damage!

The sleeping dragon falls over, gasping in pain. It drags itself off into the darkness.

Exits: north (Rockslide Cavern) or up (Cavern of the Lake of Tears)

* * *

It's a beautiful day in the dungeon, and you are a horrible goose.
Thanks to Danny O'Brien and Ada Norton for playtesting.
Thanks to Eunju Beck for the cover art.

Try typing "help" for instructions on how to play.

Roguelike Goose
An Interactive Fiction by Lizzard
Release 1 / Serial number 200112 / Inform 7 build 6M62 (I6/v6.33 lib 6/12N) SD

Mysterious ruins
Stone crumbles in a blasted wasteland. Grey, twisted trees grow from crevices in the walls. A narrow staircase descends into darkness.

>s
You can't go that way.

>d
Exits are: up (Magnificent ruins)
next room will be Disturbing Hallway
next exit will be up

Dungeon Entrance
Stone walls, mildewed with glowing stuff, widen into a large bare room.

>exits
You can go south (Disturbing Hallway) or up (Magnificent ruins) from here.

>s
Disturbing Hallway

>l
Disturbing Hallway

>exits
You can go  from here.

* * *

It's a beautiful day in the dungeon, and you are a horrible goose.
Thanks to Danny O'Brien and Ada Norton for playtesting.
Thanks to Eunju Beck for the cover art.

Try typing "help" for instructions on how to play.

Roguelike Goose
An Interactive Fiction by Lizzard
Release 1 / Serial number 200112 / Inform 7 build 6M62 (I6/v6.33 lib 6/12N) SD

Mysterious ruins
Stone crumbles in a blasted wasteland. Grey, twisted trees grow from crevices in the walls. A narrow staircase descends into darkness.

>score
Your score is 0 out of a possible 12
So far, you have defeated nothing.

>d
Grunting with effort, you clamber over the rocky floor.

The walls rumble. Rocks fall.
You can't see the sky anymore!
There is no way out.

Dungeon Entrance
Stone walls, mildewed with glowing stuff, widen into a large cold room. 

A large, colorful sign is on the wall.

You can see a trophy case (empty) here.

Exits: south (Luminous Gardens)

>look sign
A glossy sign in bright orange and virulent green, with a stylized picture of a sword on a pile of money. It says, "Welcome to your new Dungeon Away From Home! Let AirDnD be your Guide, as we bring you to new depths in Adventuring! *AirDnD*

Exits: south (Luminous Gardens)

* * *

>score
Your score is 0 out of a possible 12
So far, you have defeated nothing.

>full
Your score is 0 out of a possible 12So far, you have defeated nothing

* * *

It's a beautiful day in the dungeon, and you are a horrible goose.
Thanks to Danny O'Brien and Ada Norton for playtesting.
Thanks to Eunju Beck for the cover art.

Try typing "help" for instructions on how to play.

Roguelike Goose
An Interactive Fiction by Lizzard
Release 1 / Serial number 200112 / Inform 7 build 6M62 (I6/v6.33 lib 6/12N) SD

Mysterious ruins
Stone crumbles in a blasted wasteland. Grey, twisted trees grow from crevices in the walls. A narrow staircase descends into darkness.

>showme
Magnificent ruins - room
    yourself - person

>actions
Actions listing on.

>d
[going down]
The walls rumble. You can't see the sky anymore!
The exit from the dungeon has mysteriously closed.
[going down - succeeded]

>exits
[listing exits]
You can go  from here.

[listing exits - succeeded]

* * *

It's a beautiful day in the dungeon, and you are a horrible goose.
Thanks to Danny O'Brien and Ada Norton for playtesting.
Thanks to Eunju Beck for the cover art.

Try typing "help" for instructions on how to play.

Roguelike Goose
An Interactive Fiction by Lizzard
Release 1 / Serial number 200112 / Inform 7 build 6M62 (I6/v6.33 lib 6/12N) SD

Mysterious ruins
Stone crumbles in a blasted wasteland. Grey, twisted trees grow from crevices in the walls. A narrow staircase descends into darkness.

>sleep
You take a quick snooze and wake up again, feeling frisky.

You aren't feeling especially drowsy.

Exits: down (Dungeon Entrance)

* * *

It's a beautiful day in the dungeon, and you are a horrible goose.
Thanks to Danny O'Brien and Ada Norton for playtesting.
Thanks to Eunju Beck for the cover art.

Try typing "help" for instructions on how to play.

Roguelike Goose
An Interactive Fiction by Lizzard
Release 1 / Serial number 200112 / Inform 7 build 6M62 (I6/v6.33 lib 6/12N) SD

Mysterious ruins
Stone crumbles in a blasted wasteland. Grey, twisted trees grow from crevices in the walls. A narrow staircase descends into darkness.

>slep
That's not a verb I recognise.

>sleep
You take a quick snooze and wake up again, feeling frisky.

Exits: down (Dungeon Entrance)

>nap
You take a quick snooze and wake up again, feeling frisky.

Exits: down (Dungeon Entrance)

>d
The walls rumble. Rocks fall.
You can't see the sky anymore!
There is no way out.

Dungeon Entrance
Stone walls, mildewed with glowing stuff, widen into a large bare room.

You can see a diamond tiara, an AirDnD lanyard, a giant rat and a trophy case (empty) here.

Exits: south (Evil Archives)

* * *

It's a beautiful day in the dungeon, and you are a horrible goose.
Thanks to Danny O'Brien and Ada Norton for playtesting.
Thanks to Eunju Beck for the cover art.

Try typing "help" for instructions on how to play.

Roguelike Goose
An Interactive Fiction by Lizzard
Release 1 / Serial number 200112 / Inform 7 build 6M62 (I6/v6.33 lib 6/12N) SD

Mysterious ruins
Stone crumbles in a blasted wasteland. Grey, twisted trees grow from crevices in the walls. A narrow staircase descends into darkness.

>stats
Strength: 3   Ferocity: 2   HP: 10/10 

Exits: down (Dungeon Entrance)

>d
The walls rumble. Rocks fall.
You can't see the sky anymore!
There is no way out.

Dungeon Entrance
Stone walls, mildewed with glowing stuff, widen into a large bare room.

You can see a diamond tiara, a giant rat and a trophy case (empty) here.

Exits: west (Uncanny Lair)

>peck rat
You viciously peck the giant rat, causing 10 points of damage!

The giant rat falls over, gasping in pain.
"I went to Monster Polytechnic for this?" it shrieks, scuttling away.
It drags itself off into the darkness.

Exits: west (Uncanny Lair)

>w
Uncanny Lair
Oddly shaped bones are strewn about this rough cave. Some creature made a nest in one corner out of shredded fungus.

Exits: east (Dungeon Entrance) or down (Waterfall Cave)

>d
Waterfall Cave
Water pours down from high above, catching on stalactites and glinting in the eerie glow from the walls. A little pool lies underneath.

You can see a wispy ghost here.

Exits: north (Rockslide Cavern) or up (Uncanny Lair)

>peck ghost
You viciously peck the wispy ghost, causing 5 points of damage!
You viciously peck the wispy ghost, causing 7 points of damage!

The wispy ghost attacks you, causing 3 points of damage!

Exits: north (Rockslide Cavern) or up (Uncanny Lair)

>stats
Strength: 3   Ferocity: 2   HP: 7 

Exits: north (Rockslide Cavern) or up (Uncanny Lair)

* * *

>d
The walls rumble. Rocks fall.
You can't see the sky anymore!
There is no way out.

Dungeon Entrance
Stone walls, mildewed with glowing stuff, widen into a large bare room.

You can see a diamond tiara, a giant rat and a trophy case (empty) here.

Exits: west (Uncanny Lair)

>stats
Strength: 3   Ferocity: 0 

Exits: north (Vault of Vastness)

>x self
You crane your long, graceful neck to look back. 
White, muscular, hefty, feathered. 
Yes, you're still a fabulous goose!

Exits: north (Vault of Vastness)

* * *

>stats
Strength: 3   Ferocity: 2   HP: 10/10 

Exits: down (Dungeon Entrance)

>l
Magnificent ruins
Stone crumbles in a blasted wasteland. Grey, twisted trees grow from crevices in the walls. A narrow staircase descends into darkness. 

Exits: down (Dungeon Entrance)

* * *

>stats
Strength: 3   Ferocity: 2   HP: 10/10 

Exits: down (Dungeon Entrance)

>stats
Strength: 3 Ferocity: 0
Exits: down (Dungeon Entrance)

* * *

It's a beautiful day in the dungeon, and you are a horrible goose.
Thanks to Danny O'Brien and Ada Norton for playtesting.
Thanks to Eunju Beck for the cover art.

Try typing "help" for instructions on how to play.

Roguelike Goose
An Interactive Fiction by Lizzard
Release 1 / Serial number 200112 / Inform 7 build 6M62 (I6/v6.33 lib 6/12N) SD

Mysterious ruins
Stone crumbles in a blasted wasteland. Grey, twisted trees grow from crevices in the walls. A narrow staircase descends into darkness.

>swim
There's not enough water here for swimming.

Exits: down (Dungeon Entrance)

>d
The walls rumble. Rocks fall.
You can't see the sky anymore!
There is no way out.

Dungeon Entrance
Stone walls, mildewed with glowing stuff, widen into a large bare room.

You can see AirDnD platemail, a vial of coffee, a wispy ghost, a giant rat and a trophy case (empty) here.

Exits: east (Uncanny Lair)

>swim
There's not enough water here for swimming.

Exits: east (Uncanny Lair)

>take platemail
Taken.

Exits: east (Uncanny Lair)

>wear platemail
You put on AirDnD platemail.

Exits: east (Uncanny Lair)

* * *

>swim
There's not enough water here for swimming.

Exits: down (Dungeon Entrance)

>swim in stone
I only understood you as far as wanting to swim.

>swim in ruins
I only understood you as far as wanting to swim.

>d
The walls rumble. Rocks fall. You can't see the sky anymore!
There is no way out.

Dungeon Entrance
Stone walls, mildewed with glowing stuff, widen into a large bare room.

You can see a spider here.

Exits: north (Hall of Time)

>n
Hall of Time
Exits: south (Dungeon Entrance) or west (Evil Archives)

>w
Evil Archives
You can see a soot sprite here.

Exits: south (Vault of Vastness) or east (Hall of Time)

>s
Vault of Vastness
Exits: north (Evil Archives) or west (Luminous Gardens)

>w
Luminous Gardens
Exits: east (Vault of Vastness) or down (Waterfall Pool)

>d
You have reached a dead end.
Something stirs in the darkness.

Exits: up (Luminous Gardens)

* * *

It's a beautiful day in the dungeon, and you are a horrible goose.
Thanks to Danny O'Brien and Ada Norton for playtesting.
Thanks to Eunju Beck for the cover art.

Try typing "help" for instructions on how to play.

Roguelike Goose
An Interactive Fiction by Lizzard
Release 1 / Serial number 200112 / Inform 7 build 6M62 (I6/v6.33 lib 6/12N) SD

Mysterious ruins
Stone crumbles in a blasted wasteland. Grey, twisted trees grow from crevices in the walls. A narrow staircase descends into darkness.

>take tiara
Taken.

Exits: up (Magnificent ruins)

>wear tiara
You put on the diamond tiara.

Exits: up (Magnificent ruins)

>i
You are carrying:
  a diamond tiara (being worn)

Exits: up (Magnificent ruins)

>eq
Exits: up (Magnificent ruins)

* * *

It's a beautiful day in the dungeon, and you are a horrible goose.
Thanks to Danny O'Brien and Ada Norton for playtesting.
Thanks to Eunju Beck for the cover art.

Try typing "help" for instructions on how to play.

Roguelike Goose
An Interactive Fiction by Lizzard
Release 1 / Serial number 200112 / Inform 7 build 6M62 (I6/v6.33 lib 6/12N) SD

Mysterious ruins
Stone crumbles in a blasted wasteland. Grey, twisted trees grow from crevices in the walls. A narrow staircase descends into darkness.

>wield
That's not a verb I recognise.

>d
The walls rumble. Rocks fall.
You can't see the sky anymore!
There is no way out.

Dungeon Entrance
Stone walls, mildewed with glowing stuff, widen into a large cold room. A sign is on the wall.

You can see an AirDnD lanyard, a giant rat and a trophy case (empty) here.

Exits: east (Glittering Shrine)

>take lanyard
Taken.

Exits: east (Glittering Shrine)

>wear lanyard
You put on the AirDnD lanyard.

Exits: east (Glittering Shrine)

>stats
Strength: 3   Ferocity: 2   HP: 10/10 

Exits: east (Glittering Shrine)

>remove lanyard
You take off the AirDnD lanyard.

Exits: east (Glittering Shrine)

>stats
Strength: 3   Ferocity: 2   HP: 10/10 

Exits: east (Glittering Shrine)